Year,Quarter,Region,Economic Activity,Enterprise size,Number of enterprises,Number of Saudi employees,Number of Saudi male employees,Number of Saudi female employees,Number of Non Saudi employees,Number of Non Saudi male employees,Number of Non Saudi female employees
2023,1,Eastern Region,"Travel agencies, tour operators, reservation services and related activities",Small,54,320,137,183,523,516,7
2023,1,Eastern Region,"Travel agencies, tour operators, reservation services and related activities",Large,1,221,207,14,213,212,1
2023,1,Eastern Region,"Travel agencies, tour operators, reservation services and related activities",Micro,184,122,65,57,287,285,2
2023,1,Eastern Region,"Travel agencies, tour operators, reservation services and related activities",Medium,6,239,130,109,329,326,3
2023,1,Al Bahah Region,"Travel agencies, tour operators, reservation services and related activities",Micro,7,2,2,0,13,13,0
2023,1,Al-Jawf Region,"Travel agencies, tour operators, reservation services and related activities",Small,3,12,8,4,23,23,0
2023,1,Al-Jawf Region,"Travel agencies, tour operators, reservation services and related activities",Micro,17,6,2,4,33,33,0
2023,1,Northern border Region,"Travel agencies, tour operators, reservation services and related activities",Small,1,4,4,0,26,26,0
2023,1,Northern border Region,"Travel agencies, tour operators, reservation services and related activities",Micro,12,2,2,0,26,26,0
2023,1,Riyadh Region,"Travel agencies, tour operators, reservation services and related activities",Small,159,898,365,533,1322,1287,35
2023,1,Riyadh Region,"Travel agencies, tour operators, reservation services and related activities",Large,2,312,187,125,319,313,6
2023,1,Riyadh Region,"Travel agencies, tour operators, reservation services and related activities",Micro,411,226,98,128,738,712,26
2023,1,Riyadh Region,"Travel agencies, tour operators, reservation services and related activities",Medium,18,681,364,317,1046,1035,11
2023,1,Qassim Region,"Travel agencies, tour operators, reservation services and related activities",Small,13,31,16,15,94,92,2
2023,1,Qassim Region,"Travel agencies, tour operators, reservation services and related activities",Micro,80,24,11,13,158,157,1
2023,1,Medina Region,"Travel agencies, tour operators, reservation services and related activities",Small,28,134,58,76,254,249,5
2023,1,Medina Region,"Travel agencies, tour operators, reservation services and related activities",Micro,145,84,47,37,233,225,8
2023,1,Tabuk Region,"Travel agencies, tour operators, reservation services and related activities",Small,7,30,19,11,75,75,0
2023,1,Tabuk Region,"Travel agencies, tour operators, reservation services and related activities",Micro,40,16,7,9,67,64,3
2023,1,Jazan Region,"Travel agencies, tour operators, reservation services and related activities",Small,2,9,2,7,17,17,0
2023,1,Jazan Region,"Travel agencies, tour operators, reservation services and related activities",Micro,26,15,6,9,41,41,0
2023,1,Hail Region,"Travel agencies, tour operators, reservation services and related activities",Small,8,31,12,19,67,65,2
2023,1,Hail Region,"Travel agencies, tour operators, reservation services and related activities",Micro,20,10,8,2,42,42,0
2023,1,Asir Region,"Travel agencies, tour operators, reservation services and related activities",Small,2,11,4,7,19,19,0
2023,1,Asir Region,"Travel agencies, tour operators, reservation services and related activities",Micro,59,32,17,15,113,113,0
2023,1,Makkah Region,"Travel agencies, tour operators, reservation services and related activities",Small,200,846,500,346,1635,1603,32
2023,1,Makkah Region,"Travel agencies, tour operators, reservation services and related activities",Large,1,249,240,9,32,31,1
2023,1,Makkah Region,"Travel agencies, tour operators, reservation services and related activities",Micro,721,490,295,195,1230,1198,32
2023,1,Makkah Region,"Travel agencies, tour operators, reservation services and related activities",Medium,12,581,319,262,545,542,3
2023,1,Najran Region,"Travel agencies, tour operators, reservation services and related activities",Small,4,6,3,3,29,29,0
2023,1,Najran Region,"Travel agencies, tour operators, reservation services and related activities",Micro,15,9,5,4,28,28,0
2023,1,Eastern Region,Fishing and aquaculture,Small,138,122,47,75,1229,1228,1
2023,1,Eastern Region,Fishing and aquaculture,Micro,2055,183,82,101,5887,5873,14
2023,1,Al Bahah Region,Fishing and aquaculture,Small,2,0,0,0,13,13,0
2023,1,Al Bahah Region,Fishing and aquaculture,Micro,131,9,5,4,370,370,0
2023,1,Al-Jawf Region,Fishing and aquaculture,Small,3,5,1,4,13,13,0
2023,1,Al-Jawf Region,Fishing and aquaculture,Micro,609,43,27,16,1301,1293,8
2023,1,Northern border Region,Fishing and aquaculture,Small,1,3,1,2,16,16,0
2023,1,Northern border Region,Fishing and aquaculture,Micro,222,19,11,8,643,642,1
2023,1,Riyadh Region,Fishing and aquaculture,Small,847,612,289,323,5813,5782,31
2023,1,Riyadh Region,Fishing and aquaculture,Micro,107429,8541,4149,4392,320241,318328,1913
2023,1,Riyadh Region,Fishing and aquaculture,Medium,4,98,23,75,294,294,0
2023,1,Qassim Region,Fishing and aquaculture,Small,22,14,6,8,166,165,1
2023,1,Qassim Region,Fishing and aquaculture,Micro,2705,206,92,114,8079,8062,17
2023,1,Medina Region,Fishing and aquaculture,Small,28,21,14,7,256,256,0
2023,1,Medina Region,Fishing and aquaculture,Micro,1220,108,67,41,3241,3162,79
2023,1,Tabuk Region,Fishing and aquaculture,Small,21,2,0,2,205,205,0
2023,1,Tabuk Region,Fishing and aquaculture,Micro,469,38,18,20,1192,1188,4
2023,1,Jazan Region,Fishing and aquaculture,Small,59,87,61,26,675,674,1
2023,1,Jazan Region,Fishing and aquaculture,Micro,963,67,32,35,2357,2336,21
2023,1,Jazan Region,Fishing and aquaculture,Medium,3,37,23,14,329,328,1
2023,1,Hail Region,Fishing and aquaculture,Small,25,8,4,4,156,156,0
2023,1,Hail Region,Fishing and aquaculture,Micro,5042,324,147,177,14732,14698,34
2023,1,Asir Region,Fishing and aquaculture,Small,32,42,32,10,246,246,0
2023,1,Asir Region,Fishing and aquaculture,Micro,1100,61,27,34,2510,2499,11
2023,1,Asir Region,Fishing and aquaculture,Medium,1,6,2,4,44,44,0
2023,1,Makkah Region,Fishing and aquaculture,Small,111,78,42,36,844,839,5
2023,1,Makkah Region,Fishing and aquaculture,Large,1,271,248,23,2028,2025,3
2023,1,Makkah Region,Fishing and aquaculture,Micro,6265,496,256,240,16053,15518,535
2023,1,Makkah Region,Fishing and aquaculture,Medium,2,31,30,1,248,248,0
2023,1,Najran Region,Fishing and aquaculture,Small,20,11,2,9,140,140,0
2023,1,Najran Region,Fishing and aquaculture,Micro,2197,141,69,72,6365,6351,14
2023,1,Eastern Region,Manufacture of formed metal products (excluding machinery and equipment),Small,667,1957,1141,816,7591,7582,9
2023,1,Eastern Region,Manufacture of formed metal products (excluding machinery and equipment),Large,23,7051,6345,706,6473,6462,11
2023,1,Eastern Region,Manufacture of formed metal products (excluding machinery and equipment),Micro,1486,452,244,208,3397,3395,2
2023,1,Eastern Region,Manufacture of formed metal products (excluding machinery and equipment),Medium,111,3037,2190,847,8358,8348,10
2023,1,Al Bahah Region,Manufacture of formed metal products (excluding machinery and equipment),Small,21,23,13,10,120,120,0
2023,1,Al Bahah Region,Manufacture of formed metal products (excluding machinery and equipment),Micro,327,50,34,16,661,661,0
2023,1,Al-Jawf Region,Manufacture of formed metal products (excluding machinery and equipment),Small,28,35,24,11,239,239,0
2023,1,Al-Jawf Region,Manufacture of formed metal products (excluding machinery and equipment),Micro,311,29,25,4,698,697,1
2023,1,Northern border Region,Manufacture of formed metal products (excluding machinery and equipment),Small,19,35,19,16,225,225,0
2023,1,Northern border Region,Manufacture of formed metal products (excluding machinery and equipment),Micro,121,17,6,11,293,290,3
2023,1,Riyadh Region,Manufacture of formed metal products (excluding machinery and equipment),Small,963,3064,1267,1797,12531,12482,49
2023,1,Riyadh Region,Manufacture of formed metal products (excluding machinery and equipment),Large,18,2327,1442,885,6480,6457,23
2023,1,Riyadh Region,Manufacture of formed metal products (excluding machinery and equipment),Micro,2666,632,291,341,6043,6014,29
2023,1,Riyadh Region,Manufacture of formed metal products (excluding machinery and equipment),Medium,174,4104,2067,2037,13034,13007,27
2023,1,Qassim Region,Manufacture of formed metal products (excluding machinery and equipment),Small,169,336,190,146,1632,1630,2
2023,1,Qassim Region,Manufacture of formed metal products (excluding machinery and equipment),Large,1,117,96,21,376,376,0
2023,1,Qassim Region,Manufacture of formed metal products (excluding machinery and equipment),Micro,1240,185,104,81,2973,2968,5
2023,1,Qassim Region,Manufacture of formed metal products (excluding machinery and equipment),Medium,9,164,101,63,654,653,1
2023,1,Medina Region,Manufacture of formed metal products (excluding machinery and equipment),Small,97,198,91,107,974,973,1
2023,1,Medina Region,Manufacture of formed metal products (excluding machinery and equipment),Micro,667,114,66,48,1543,1541,2
2023,1,Medina Region,Manufacture of formed metal products (excluding machinery and equipment),Medium,9,337,219,118,748,746,2
2023,1,Tabuk Region,Manufacture of formed metal products (excluding machinery and equipment),Small,33,70,42,28,360,359,1
2023,1,Tabuk Region,Manufacture of formed metal products (excluding machinery and equipment),Micro,227,40,22,18,562,561,1
2023,1,Tabuk Region,Manufacture of formed metal products (excluding machinery and equipment),Medium,2,43,21,22,117,116,1
2023,1,Jazan Region,Manufacture of formed metal products (excluding machinery and equipment),Small,42,91,57,34,361,360,1
2023,1,Jazan Region,Manufacture of formed metal products (excluding machinery and equipment),Micro,844,87,51,36,2073,2071,2
2023,1,Jazan Region,Manufacture of formed metal products (excluding machinery and equipment),Medium,1,15,5,10,41,41,0
2023,1,Hail Region,Manufacture of formed metal products (excluding machinery and equipment),Small,56,112,42,70,600,600,0
2023,1,Hail Region,Manufacture of formed metal products (excluding machinery and equipment),Micro,238,45,21,24,528,525,3
2023,1,Hail Region,Manufacture of formed metal products (excluding machinery and equipment),Medium,2,55,37,18,66,66,0
2023,1,Asir Region,Manufacture of formed metal products (excluding machinery and equipment),Small,90,231,130,101,921,921,0
2023,1,Asir Region,Manufacture of formed metal products (excluding machinery and equipment),Micro,1111,159,82,77,2565,2565,0
2023,1,Asir Region,Manufacture of formed metal products (excluding machinery and equipment),Medium,8,109,57,52,513,513,0
2023,1,Makkah Region,Manufacture of formed metal products (excluding machinery and equipment),Small,374,1042,514,528,4484,4455,29
2023,1,Makkah Region,Manufacture of formed metal products (excluding machinery and equipment),Large,9,930,679,251,2426,2420,6
2023,1,Makkah Region,Manufacture of formed metal products (excluding machinery and equipment),Micro,2173,328,178,150,5128,5113,15
2023,1,Makkah Region,Manufacture of formed metal products (excluding machinery and equipment),Medium,77,2245,1563,682,6498,6476,22
2023,1,Najran Region,Manufacture of formed metal products (excluding machinery and equipment),Small,14,14,4,10,101,101,0
2023,1,Najran Region,Manufacture of formed metal products (excluding machinery and equipment),Micro,343,33,14,19,839,837,2
2023,1,Najran Region,Manufacture of formed metal products (excluding machinery and equipment),Medium,1,7,3,4,44,44,0
2023,1,Eastern Region,Manufacture of other non-metallic mineral products,Small,296,1070,606,464,4687,4684,3
2023,1,Eastern Region,Manufacture of other non-metallic mineral products,Large,16,2176,1684,492,5396,5392,4
2023,1,Eastern Region,Manufacture of other non-metallic mineral products,Micro,377,128,77,51,902,899,3
2023,1,Eastern Region,Manufacture of other non-metallic mineral products,Medium,139,3245,2010,1235,10389,10328,61
2023,1,Al Bahah Region,Manufacture of other non-metallic mineral products,Small,27,122,73,49,515,515,0
2023,1,Al Bahah Region,Manufacture of other non-metallic mineral products,Micro,43,13,11,2,87,87,0
2023,1,Al Bahah Region,Manufacture of other non-metallic mineral products,Medium,7,120,68,52,438,434,4
2023,1,Al-Jawf Region,Manufacture of other non-metallic mineral products,Small,31,103,60,43,415,414,1
2023,1,Al-Jawf Region,Manufacture of other non-metallic mineral products,Micro,39,3,3,0,85,84,1
2023,1,Al-Jawf Region,Manufacture of other non-metallic mineral products,Medium,15,297,214,83,1084,1084,0
2023,1,Northern border Region,Manufacture of other non-metallic mineral products,Small,21,58,31,27,302,302,0
2023,1,Northern border Region,Manufacture of other non-metallic mineral products,Large,1,215,213,2,184,184,0
2023,1,Northern border Region,Manufacture of other non-metallic mineral products,Micro,36,9,6,3,84,84,0
2023,1,Northern border Region,Manufacture of other non-metallic mineral products,Medium,4,93,51,42,269,268,1
2023,1,Riyadh Region,Manufacture of other non-metallic mineral products,Small,1390,2186,962,1224,23976,23862,114
2023,1,Riyadh Region,Manufacture of other non-metallic mineral products,Large,38,5463,3622,1841,12515,12489,26
2023,1,Riyadh Region,Manufacture of other non-metallic mineral products,Micro,1781,307,160,147,4621,4585,36
2023,1,Riyadh Region,Manufacture of other non-metallic mineral products,Medium,373,5217,2547,2670,27579,27525,54
2023,1,Qassim Region,Manufacture of other non-metallic mineral products,Small,167,437,255,182,2840,2836,4
2023,1,Qassim Region,Manufacture of other non-metallic mineral products,Large,8,903,737,166,2554,2553,1
2023,1,Qassim Region,Manufacture of other non-metallic mineral products,Micro,273,49,31,18,711,710,1
2023,1,Qassim Region,Manufacture of other non-metallic mineral products,Medium,44,955,548,407,3337,3337,0
2023,1,Medina Region,Manufacture of other non-metallic mineral products,Small,101,262,167,95,1416,1414,2
2023,1,Medina Region,Manufacture of other non-metallic mineral products,Large,7,1155,795,360,2491,2488,3
2023,1,Medina Region,Manufacture of other non-metallic mineral products,Micro,174,37,27,10,410,402,8
2023,1,Medina Region,Manufacture of other non-metallic mineral products,Medium,42,1046,753,293,3748,3744,4
2023,1,Tabuk Region,Manufacture of other non-metallic mineral products,Small,30,113,63,50,374,370,4
2023,1,Tabuk Region,Manufacture of other non-metallic mineral products,Large,2,381,353,28,533,533,0
2023,1,Tabuk Region,Manufacture of other non-metallic mineral products,Micro,50,17,9,8,112,112,0
2023,1,Tabuk Region,Manufacture of other non-metallic mineral products,Medium,8,221,145,76,694,694,0
2023,1,Jazan Region,Manufacture of other non-metallic mineral products,Small,73,198,115,83,1085,1083,2
2023,1,Jazan Region,Manufacture of other non-metallic mineral products,Large,2,433,418,15,343,343,0
2023,1,Jazan Region,Manufacture of other non-metallic mineral products,Micro,141,28,20,8,338,337,1
2023,1,Jazan Region,Manufacture of other non-metallic mineral products,Medium,31,683,417,266,2013,2013,0
2023,1,Hail Region,Manufacture of other non-metallic mineral products,Small,40,68,37,31,489,489,0
2023,1,Hail Region,Manufacture of other non-metallic mineral products,Large,1,254,254,0,164,163,1
2023,1,Hail Region,Manufacture of other non-metallic mineral products,Micro,137,25,17,8,324,324,0
2023,1,Hail Region,Manufacture of other non-metallic mineral products,Medium,11,201,120,81,945,945,0
2023,1,Asir Region,Manufacture of other non-metallic mineral products,Small,159,518,324,194,2339,2331,8
2023,1,Asir Region,Manufacture of other non-metallic mineral products,Large,6,1082,836,246,1727,1726,1
2023,1,Asir Region,Manufacture of other non-metallic mineral products,Micro,292,63,33,30,751,746,5
2023,1,Asir Region,Manufacture of other non-metallic mineral products,Medium,45,971,574,397,3336,3335,1
2023,1,Makkah Region,Manufacture of other non-metallic mineral products,Small,268,778,389,389,3742,3728,14
2023,1,Makkah Region,Manufacture of other non-metallic mineral products,Large,16,2973,1981,992,6085,6078,7
2023,1,Makkah Region,Manufacture of other non-metallic mineral products,Micro,511,150,85,65,1234,1224,10
2023,1,Makkah Region,Manufacture of other non-metallic mineral products,Medium,101,2289,1358,931,7804,7794,10
2023,1,Najran Region,Manufacture of other non-metallic mineral products,Small,35,89,41,48,502,501,1
2023,1,Najran Region,Manufacture of other non-metallic mineral products,Large,1,344,326,18,423,423,0
2023,1,Najran Region,Manufacture of other non-metallic mineral products,Micro,77,13,7,6,203,203,0
2023,1,Najran Region,Manufacture of other non-metallic mineral products,Medium,25,526,289,237,1809,1804,5
2023,1,Eastern Region,Manufacture of rubber and plastics products,Small,66,276,177,99,1012,1011,1
2023,1,Eastern Region,Manufacture of rubber and plastics products,Large,3,423,404,19,885,885,0
2023,1,Eastern Region,Manufacture of rubber and plastics products,Micro,53,36,15,21,117,117,0
2023,1,Eastern Region,Manufacture of rubber and plastics products,Medium,36,1051,783,268,2635,2629,6
2023,1,Al Bahah Region,Manufacture of rubber and plastics products,Micro,2,0,0,0,5,5,0
2023,1,Al-Jawf Region,Manufacture of rubber and plastics products,Small,2,15,8,7,31,31,0
2023,1,Al-Jawf Region,Manufacture of rubber and plastics products,Large,1,118,82,36,382,382,0
2023,1,Al-Jawf Region,Manufacture of rubber and plastics products,Micro,14,2,1,1,37,37,0
2023,1,Northern border Region,Manufacture of rubber and plastics products,Small,1,3,1,2,6,6,0
2023,1,Northern border Region,Manufacture of rubber and plastics products,Micro,1,0,0,0,1,1,0
2023,1,Riyadh Region,Manufacture of rubber and plastics products,Small,144,668,283,385,2598,2583,15
2023,1,Riyadh Region,Manufacture of rubber and plastics products,Large,10,926,462,464,3184,3179,5
2023,1,Riyadh Region,Manufacture of rubber and plastics products,Micro,221,74,35,39,546,537,9
2023,1,Riyadh Region,Manufacture of rubber and plastics products,Medium,93,2553,1325,1228,7828,7816,12
2023,1,Qassim Region,Manufacture of rubber and plastics products,Small,4,21,7,14,61,61,0
2023,1,Qassim Region,Manufacture of rubber and plastics products,Micro,18,6,1,5,31,30,1
2023,1,Qassim Region,Manufacture of rubber and plastics products,Medium,8,255,160,95,654,653,1
2023,1,Medina Region,Manufacture of rubber and plastics products,Small,25,130,68,62,511,511,0
2023,1,Medina Region,Manufacture of rubber and plastics products,Large,1,127,63,64,333,333,0
2023,1,Medina Region,Manufacture of rubber and plastics products,Micro,22,11,5,6,31,31,0
2023,1,Medina Region,Manufacture of rubber and plastics products,Medium,8,232,144,88,681,677,4
2023,1,Tabuk Region,Manufacture of rubber and plastics products,Small,7,30,16,14,98,98,0
2023,1,Tabuk Region,Manufacture of rubber and plastics products,Micro,4,3,1,2,8,8,0
2023,1,Tabuk Region,Manufacture of rubber and plastics products,Medium,1,20,12,8,77,77,0
2023,1,Jazan Region,Manufacture of rubber and plastics products,Small,1,2,1,1,8,8,0
2023,1,Jazan Region,Manufacture of rubber and plastics products,Micro,8,1,1,0,27,27,0
2023,1,Hail Region,Manufacture of rubber and plastics products,Small,3,19,10,9,55,55,0
2023,1,Hail Region,Manufacture of rubber and plastics products,Micro,5,0,0,0,11,11,0
2023,1,Hail Region,Manufacture of rubber and plastics products,Medium,2,109,83,26,149,149,0
2023,1,Asir Region,Manufacture of rubber and plastics products,Small,7,22,11,11,85,85,0
2023,1,Asir Region,Manufacture of rubber and plastics products,Micro,25,9,4,5,50,50,0
2023,1,Asir Region,Manufacture of rubber and plastics products,Medium,4,80,45,35,237,237,0
2023,1,Makkah Region,Manufacture of rubber and plastics products,Small,86,446,231,215,1561,1551,10
2023,1,Makkah Region,Manufacture of rubber and plastics products,Large,12,1419,1072,347,3148,3134,14
2023,1,Makkah Region,Manufacture of rubber and plastics products,Micro,77,33,23,10,169,168,1
2023,1,Makkah Region,Manufacture of rubber and plastics products,Medium,34,852,407,445,2976,2973,3
2023,1,Najran Region,Manufacture of rubber and plastics products,Small,3,19,10,9,66,66,0
2023,1,Najran Region,Manufacture of rubber and plastics products,Micro,11,4,3,1,33,33,0
2023,1,Najran Region,Manufacture of rubber and plastics products,Medium,3,53,18,35,244,244,0
2023,1,Eastern Region,Manufacture of coke and refined petroleum products,Small,26,145,93,52,467,467,0
2023,1,Eastern Region,Manufacture of coke and refined petroleum products,Large,8,4165,4105,60,1618,1617,1
2023,1,Eastern Region,Manufacture of coke and refined petroleum products,Micro,11,8,4,4,18,17,1
2023,1,Eastern Region,Manufacture of coke and refined petroleum products,Medium,7,523,506,17,633,633,0
2023,1,Riyadh Region,Manufacture of coke and refined petroleum products,Small,33,193,114,79,428,425,3
2023,1,Riyadh Region,Manufacture of coke and refined petroleum products,Micro,38,33,19,14,60,59,1
2023,1,Riyadh Region,Manufacture of coke and refined petroleum products,Medium,5,163,112,51,346,346,0
2023,1,Qassim Region,Manufacture of coke and refined petroleum products,Small,4,27,24,3,77,77,0
2023,1,Qassim Region,Manufacture of coke and refined petroleum products,Micro,3,1,1,0,7,7,0
2023,1,Medina Region,Manufacture of coke and refined petroleum products,Small,2,16,15,1,34,34,0
2023,1,Medina Region,Manufacture of coke and refined petroleum products,Large,4,2073,2008,65,498,498,0
2023,1,Medina Region,Manufacture of coke and refined petroleum products,Micro,5,5,3,2,9,9,0
2023,1,Medina Region,Manufacture of coke and refined petroleum products,Medium,4,203,199,4,464,464,0
2023,1,Tabuk Region,Manufacture of coke and refined petroleum products,Small,1,3,3,0,8,8,0
2023,1,Tabuk Region,Manufacture of coke and refined petroleum products,Micro,1,1,0,1,0,0,0
2023,1,Jazan Region,Manufacture of coke and refined petroleum products,Large,1,236,228,8,63,59,4
2023,1,Jazan Region,Manufacture of coke and refined petroleum products,Micro,2,1,1,0,3,3,0
2023,1,Hail Region,Manufacture of coke and refined petroleum products,Micro,1,0,0,0,3,3,0
2023,1,Asir Region,Manufacture of coke and refined petroleum products,Small,1,6,3,3,19,19,0
2023,1,Asir Region,Manufacture of coke and refined petroleum products,Medium,1,16,9,7,46,46,0
2023,1,Makkah Region,Manufacture of coke and refined petroleum products,Small,19,100,58,42,259,257,2
2023,1,Makkah Region,Manufacture of coke and refined petroleum products,Large,4,3156,3055,101,1479,1464,15
2023,1,Makkah Region,Manufacture of coke and refined petroleum products,Micro,18,13,9,4,30,29,1
2023,1,Makkah Region,Manufacture of coke and refined petroleum products,Medium,5,146,127,19,176,175,1
2023,1,Eastern Region,Manufacture of paper and paper products,Small,51,297,154,143,941,938,3
2023,1,Eastern Region,Manufacture of paper and paper products,Large,7,723,559,164,1726,1722,4
2023,1,Eastern Region,Manufacture of paper and paper products,Micro,46,27,10,17,98,97,1
2023,1,Eastern Region,Manufacture of paper and paper products,Medium,23,742,483,259,1827,1821,6
2023,1,Al-Jawf Region,Manufacture of paper and paper products,Small,1,2,2,0,9,9,0
2023,1,Al-Jawf Region,Manufacture of paper and paper products,Micro,2,0,0,0,6,6,0
2023,1,Northern border Region,Manufacture of paper and paper products,Small,2,3,1,2,25,25,0
2023,1,Northern border Region,Manufacture of paper and paper products,Micro,1,0,0,0,1,1,0
2023,1,Riyadh Region,Manufacture of paper and paper products,Small,113,576,230,346,1757,1743,14
2023,1,Riyadh Region,Manufacture of paper and paper products,Large,2,146,33,113,383,383,0
2023,1,Riyadh Region,Manufacture of paper and paper products,Micro,119,52,24,28,271,268,3
2023,1,Riyadh Region,Manufacture of paper and paper products,Medium,44,1161,661,500,3518,3504,14
2023,1,Qassim Region,Manufacture of paper and paper products,Small,12,46,21,25,175,174,1
2023,1,Qassim Region,Manufacture of paper and paper products,Micro,18,5,1,4,42,42,0
2023,1,Qassim Region,Manufacture of paper and paper products,Medium,4,102,61,41,344,344,0
2023,1,Medina Region,Manufacture of paper and paper products,Small,13,55,28,27,202,197,5
2023,1,Medina Region,Manufacture of paper and paper products,Micro,15,6,1,5,21,21,0
2023,1,Medina Region,Manufacture of paper and paper products,Medium,2,32,26,6,108,108,0
2023,1,Tabuk Region,Manufacture of paper and paper products,Small,4,16,9,7,72,72,0
2023,1,Tabuk Region,Manufacture of paper and paper products,Micro,3,0,0,0,7,7,0
2023,1,Tabuk Region,Manufacture of paper and paper products,Medium,1,19,7,12,40,40,0
2023,1,Jazan Region,Manufacture of paper and paper products,Small,3,8,3,5,20,20,0
2023,1,Jazan Region,Manufacture of paper and paper products,Micro,4,1,0,1,11,11,0
2023,1,Jazan Region,Manufacture of paper and paper products,Medium,1,26,10,16,84,84,0
2023,1,Hail Region,Manufacture of paper and paper products,Small,4,20,5,15,52,52,0
2023,1,Hail Region,Manufacture of paper and paper products,Micro,5,1,1,0,19,19,0
2023,1,Asir Region,Manufacture of paper and paper products,Small,10,32,15,17,104,104,0
2023,1,Asir Region,Manufacture of paper and paper products,Micro,10,5,3,2,27,27,0
2023,1,Asir Region,Manufacture of paper and paper products,Medium,1,16,3,13,49,49,0
2023,1,Makkah Region,Manufacture of paper and paper products,Small,82,340,199,141,1140,1135,5
2023,1,Makkah Region,Manufacture of paper and paper products,Large,4,602,453,149,1412,1402,10
2023,1,Makkah Region,Manufacture of paper and paper products,Micro,58,29,14,15,123,117,6
2023,1,Makkah Region,Manufacture of paper and paper products,Medium,32,977,506,471,2330,2318,12
2023,1,Najran Region,Manufacture of paper and paper products,Small,2,5,3,2,37,37,0
2023,1,Najran Region,Manufacture of paper and paper products,Micro,20,3,1,2,46,46,0
2023,1,Eastern Region,Manufacture of chemicals and chemical products,Small,190,1169,784,385,3018,3001,17
2023,1,Eastern Region,Manufacture of chemicals and chemical products,Large,19,10830,10565,265,3388,3388,0
2023,1,Eastern Region,Manufacture of chemicals and chemical products,Micro,134,68,45,23,259,258,1
2023,1,Eastern Region,Manufacture of chemicals and chemical products,Medium,96,3579,3031,548,6260,6253,7
2023,1,Al Bahah Region,Manufacture of chemicals and chemical products,Small,4,7,6,1,28,28,0
2023,1,Al Bahah Region,Manufacture of chemicals and chemical products,Micro,4,0,0,0,11,11,0
2023,1,Al Bahah Region,Manufacture of chemicals and chemical products,Medium,1,19,5,14,50,50,0
2023,1,Al-Jawf Region,Manufacture of chemicals and chemical products,Small,2,3,0,3,10,10,0
2023,1,Al-Jawf Region,Manufacture of chemicals and chemical products,Micro,8,1,1,0,15,15,0
2023,1,Northern border Region,Manufacture of chemicals and chemical products,Small,2,13,13,0,7,7,0
2023,1,Northern border Region,Manufacture of chemicals and chemical products,Large,1,547,530,17,147,146,1
2023,1,Northern border Region,Manufacture of chemicals and chemical products,Micro,7,2,2,0,11,11,0
2023,1,Riyadh Region,Manufacture of chemicals and chemical products,Small,423,1953,844,1109,6623,6584,39
2023,1,Riyadh Region,Manufacture of chemicals and chemical products,Large,16,3988,2755,1233,4543,4526,17
2023,1,Riyadh Region,Manufacture of chemicals and chemical products,Micro,486,194,98,96,1008,991,17
2023,1,Riyadh Region,Manufacture of chemicals and chemical products,Medium,108,2737,1397,1340,7530,7516,14
2023,1,Qassim Region,Manufacture of chemicals and chemical products,Small,21,70,41,29,296,295,1
2023,1,Qassim Region,Manufacture of chemicals and chemical products,Large,2,448,416,32,1359,1358,1
2023,1,Qassim Region,Manufacture of chemicals and chemical products,Micro,27,13,7,6,53,53,0
2023,1,Qassim Region,Manufacture of chemicals and chemical products,Medium,7,189,116,73,564,564,0
2023,1,Medina Region,Manufacture of chemicals and chemical products,Small,34,184,139,45,446,444,2
2023,1,Medina Region,Manufacture of chemicals and chemical products,Large,5,2785,2764,21,655,655,0
2023,1,Medina Region,Manufacture of chemicals and chemical products,Micro,35,16,5,11,63,61,2
2023,1,Medina Region,Manufacture of chemicals and chemical products,Medium,15,487,425,62,793,792,1
2023,1,Tabuk Region,Manufacture of chemicals and chemical products,Small,11,60,38,22,198,196,2
2023,1,Tabuk Region,Manufacture of chemicals and chemical products,Large,1,372,218,154,513,512,1
2023,1,Tabuk Region,Manufacture of chemicals and chemical products,Micro,18,5,3,2,42,42,0
2023,1,Jazan Region,Manufacture of chemicals and chemical products,Small,10,26,9,17,100,99,1
2023,1,Jazan Region,Manufacture of chemicals and chemical products,Micro,18,7,3,4,48,46,2
2023,1,Jazan Region,Manufacture of chemicals and chemical products,Medium,1,9,9,0,66,66,0
2023,1,Hail Region,Manufacture of chemicals and chemical products,Small,11,14,6,8,121,121,0
2023,1,Hail Region,Manufacture of chemicals and chemical products,Micro,55,8,5,3,152,152,0
2023,1,Hail Region,Manufacture of chemicals and chemical products,Medium,1,6,5,1,44,44,0
2023,1,Asir Region,Manufacture of chemicals and chemical products,Small,25,97,52,45,415,413,2
2023,1,Asir Region,Manufacture of chemicals and chemical products,Large,1,613,491,122,1405,1401,4
2023,1,Asir Region,Manufacture of chemicals and chemical products,Micro,32,12,8,4,68,68,0
2023,1,Asir Region,Manufacture of chemicals and chemical products,Medium,5,130,84,46,341,341,0
2023,1,Makkah Region,Manufacture of chemicals and chemical products,Small,206,1008,518,490,3272,3239,33
2023,1,Makkah Region,Manufacture of chemicals and chemical products,Large,4,719,533,186,1467,1463,4
2023,1,Makkah Region,Manufacture of chemicals and chemical products,Micro,250,126,70,56,512,497,15
2023,1,Makkah Region,Manufacture of chemicals and chemical products,Medium,77,2207,1320,887,5379,5345,34
2023,1,Najran Region,Manufacture of chemicals and chemical products,Small,5,18,15,3,101,101,0
2023,1,Najran Region,Manufacture of chemicals and chemical products,Micro,10,1,1,0,21,21,0
2023,1,Najran Region,Manufacture of chemicals and chemical products,Medium,3,61,23,38,160,160,0
2023,1,Eastern Region,Manufacture of textiles,Small,78,176,85,91,819,806,13
2023,1,Eastern Region,Manufacture of textiles,Large,1,69,47,22,183,183,0
2023,1,Eastern Region,Manufacture of textiles,Micro,305,60,29,31,675,661,14
2023,1,Eastern Region,Manufacture of textiles,Medium,7,164,139,25,636,635,1
2023,1,Al Bahah Region,Manufacture of textiles,Small,2,5,3,2,24,24,0
2023,1,Al Bahah Region,Manufacture of textiles,Micro,21,5,1,4,55,54,1
2023,1,Al-Jawf Region,Manufacture of textiles,Small,4,3,1,2,25,25,0
2023,1,Al-Jawf Region,Manufacture of textiles,Micro,64,9,5,4,155,154,1
2023,1,Northern border Region,Manufacture of textiles,Small,2,1,1,0,14,14,0
2023,1,Northern border Region,Manufacture of textiles,Micro,27,6,5,1,62,62,0
2023,1,Riyadh Region,Manufacture of textiles,Small,108,253,96,157,1186,1181,5
2023,1,Riyadh Region,Manufacture of textiles,Large,7,1507,1032,475,3850,3822,28
2023,1,Riyadh Region,Manufacture of textiles,Micro,554,94,33,61,1286,1276,10
2023,1,Riyadh Region,Manufacture of textiles,Medium,12,312,171,141,974,971,3
2023,1,Qassim Region,Manufacture of textiles,Small,14,29,27,2,112,112,0
2023,1,Qassim Region,Manufacture of textiles,Micro,86,18,8,10,211,211,0
2023,1,Qassim Region,Manufacture of textiles,Medium,2,38,24,14,86,86,0
2023,1,Medina Region,Manufacture of textiles,Small,20,42,33,9,188,188,0
2023,1,Medina Region,Manufacture of textiles,Micro,144,22,7,15,315,306,9
2023,1,Medina Region,Manufacture of textiles,Medium,5,114,69,45,358,357,1
2023,1,Tabuk Region,Manufacture of textiles,Small,6,4,0,4,37,37,0
2023,1,Tabuk Region,Manufacture of textiles,Micro,72,10,6,4,167,165,2
2023,1,Jazan Region,Manufacture of textiles,Small,1,3,2,1,7,7,0
2023,1,Jazan Region,Manufacture of textiles,Micro,32,4,2,2,69,69,0
2023,1,Hail Region,Manufacture of textiles,Small,7,13,7,6,67,67,0
2023,1,Hail Region,Manufacture of textiles,Micro,49,4,0,4,120,120,0
2023,1,Asir Region,Manufacture of textiles,Small,6,6,4,2,45,45,0
2023,1,Asir Region,Manufacture of textiles,Micro,70,13,8,5,158,155,3
2023,1,Makkah Region,Manufacture of textiles,Small,56,152,48,104,700,696,4
2023,1,Makkah Region,Manufacture of textiles,Large,2,214,206,8,663,663,0
2023,1,Makkah Region,Manufacture of textiles,Micro,282,56,31,25,629,616,13
2023,1,Makkah Region,Manufacture of textiles,Medium,9,258,170,88,763,762,1
2023,1,Najran Region,Manufacture of textiles,Small,3,2,0,2,27,22,5
2023,1,Najran Region,Manufacture of textiles,Micro,51,6,3,3,123,120,3
2023,1,Eastern Region,Manufacture of food products,Small,335,1187,558,629,4514,4497,17
2023,1,Eastern Region,Manufacture of food products,Large,15,1606,854,752,5039,5031,8
2023,1,Eastern Region,Manufacture of food products,Micro,736,257,124,133,1551,1546,5
2023,1,Eastern Region,Manufacture of food products,Medium,84,1986,1111,875,5973,5947,26
2023,1,Al Bahah Region,Manufacture of food products,Small,20,36,20,16,175,174,1
2023,1,Al Bahah Region,Manufacture of food products,Micro,98,15,10,5,196,196,0
2023,1,Al Bahah Region,Manufacture of food products,Medium,1,9,4,5,53,53,0
2023,1,Al-Jawf Region,Manufacture of food products,Small,39,78,43,35,348,347,1
2023,1,Al-Jawf Region,Manufacture of food products,Micro,173,29,21,8,357,357,0
2023,1,Al-Jawf Region,Manufacture of food products,Medium,2,62,53,9,111,111,0
2023,1,Northern border Region,Manufacture of food products,Small,18,30,15,15,189,189,0
2023,1,Northern border Region,Manufacture of food products,Micro,108,14,10,4,244,244,0
2023,1,Northern border Region,Manufacture of food products,Medium,1,3,2,1,57,57,0
2023,1,Riyadh Region,Manufacture of food products,Small,601,1993,789,1204,8316,8224,92
2023,1,Riyadh Region,Manufacture of food products,Large,51,8110,5762,2348,25787,25699,88
2023,1,Riyadh Region,Manufacture of food products,Micro,1898,500,196,304,3956,3919,37
2023,1,Riyadh Region,Manufacture of food products,Medium,174,4066,1917,2149,13587,13517,70
2023,1,Qassim Region,Manufacture of food products,Small,115,475,258,217,1656,1649,7
2023,1,Qassim Region,Manufacture of food products,Large,11,958,651,307,3667,3562,105
2023,1,Qassim Region,Manufacture of food products,Micro,421,87,56,31,906,903,3
2023,1,Qassim Region,Manufacture of food products,Medium,60,1495,872,623,4840,4834,6
2023,1,Medina Region,Manufacture of food products,Small,133,442,225,217,1735,1724,11
2023,1,Medina Region,Manufacture of food products,Large,1,116,83,33,319,319,0
2023,1,Medina Region,Manufacture of food products,Micro,522,129,74,55,1105,1090,15
2023,1,Medina Region,Manufacture of food products,Medium,15,567,401,166,1422,1421,1
2023,1,Tabuk Region,Manufacture of food products,Small,33,89,55,34,427,427,0
2023,1,Tabuk Region,Manufacture of food products,Large,2,199,42,157,622,621,1
2023,1,Tabuk Region,Manufacture of food products,Micro,217,48,18,30,424,424,0
2023,1,Tabuk Region,Manufacture of food products,Medium,8,144,44,100,585,585,0
2023,1,Jazan Region,Manufacture of food products,Small,57,157,76,81,687,681,6
2023,1,Jazan Region,Manufacture of food products,Micro,301,56,35,21,653,649,4
2023,1,Jazan Region,Manufacture of food products,Medium,6,184,100,84,557,556,1
2023,1,Hail Region,Manufacture of food products,Small,32,95,37,58,389,388,1
2023,1,Hail Region,Manufacture of food products,Large,1,82,36,46,200,199,1
2023,1,Hail Region,Manufacture of food products,Micro,214,44,23,21,466,464,2
2023,1,Hail Region,Manufacture of food products,Medium,10,258,78,180,788,783,5
2023,1,Asir Region,Manufacture of food products,Small,91,272,120,152,1218,1217,1
2023,1,Asir Region,Manufacture of food products,Large,4,317,175,142,1670,1670,0
2023,1,Asir Region,Manufacture of food products,Micro,532,116,59,57,1051,1050,1
2023,1,Asir Region,Manufacture of food products,Medium,15,400,216,184,1068,1068,0
2023,1,Makkah Region,Manufacture of food products,Small,439,1470,701,769,5474,5421,53
2023,1,Makkah Region,Manufacture of food products,Large,35,6410,3373,3037,16859,16496,363
2023,1,Makkah Region,Manufacture of food products,Micro,1492,376,183,193,3243,3215,28
2023,1,Makkah Region,Manufacture of food products,Medium,110,2809,1340,1469,8760,8706,54
2023,1,Najran Region,Manufacture of food products,Small,18,41,15,26,207,207,0
2023,1,Najran Region,Manufacture of food products,Micro,179,28,14,14,394,391,3
2023,1,Eastern Region,Manufacture of essential pharmaceutical products and pharmaceutical preparations,Small,8,36,18,18,98,81,17
2023,1,Eastern Region,Manufacture of essential pharmaceutical products and pharmaceutical preparations,Large,1,180,115,65,387,383,4
2023,1,Eastern Region,Manufacture of essential pharmaceutical products and pharmaceutical preparations,Micro,12,6,2,4,26,24,2
2023,1,Eastern Region,Manufacture of essential pharmaceutical products and pharmaceutical preparations,Medium,5,218,158,60,298,292,6
2023,1,Al Bahah Region,Manufacture of essential pharmaceutical products and pharmaceutical preparations,Micro,1,0,0,0,2,2,0
2023,1,Al-Jawf Region,Manufacture of essential pharmaceutical products and pharmaceutical preparations,Micro,6,0,0,0,16,16,0
2023,1,Northern border Region,Manufacture of essential pharmaceutical products and pharmaceutical preparations,Micro,3,3,1,2,5,5,0
2023,1,Riyadh Region,Manufacture of essential pharmaceutical products and pharmaceutical preparations,Small,32,192,84,108,388,381,7
2023,1,Riyadh Region,Manufacture of essential pharmaceutical products and pharmaceutical preparations,Large,5,582,296,286,1485,1457,28
2023,1,Riyadh Region,Manufacture of essential pharmaceutical products and pharmaceutical preparations,Micro,257,50,19,31,703,698,5
2023,1,Riyadh Region,Manufacture of essential pharmaceutical products and pharmaceutical preparations,Medium,11,315,122,193,691,679,12
2023,1,Qassim Region,Manufacture of essential pharmaceutical products and pharmaceutical preparations,Small,1,1,1,0,14,14,0
2023,1,Qassim Region,Manufacture of essential pharmaceutical products and pharmaceutical preparations,Large,1,337,310,27,353,353,0
2023,1,Qassim Region,Manufacture of essential pharmaceutical products and pharmaceutical preparations,Micro,11,1,0,1,28,28,0
2023,1,Qassim Region,Manufacture of essential pharmaceutical products and pharmaceutical preparations,Medium,1,30,25,5,83,75,8
2023,1,Medina Region,Manufacture of essential pharmaceutical products and pharmaceutical preparations,Small,1,9,8,1,28,28,0
2023,1,Medina Region,Manufacture of essential pharmaceutical products and pharmaceutical preparations,Micro,6,1,0,1,9,9,0
2023,1,Tabuk Region,Manufacture of essential pharmaceutical products and pharmaceutical preparations,Micro,3,0,0,0,8,8,0
2023,1,Jazan Region,Manufacture of essential pharmaceutical products and pharmaceutical preparations,Micro,5,0,0,0,11,9,2
2023,1,Hail Region,Manufacture of essential pharmaceutical products and pharmaceutical preparations,Small,1,2,0,2,5,5,0
2023,1,Hail Region,Manufacture of essential pharmaceutical products and pharmaceutical preparations,Micro,7,1,1,0,18,18,0
2023,1,Hail Region,Manufacture of essential pharmaceutical products and pharmaceutical preparations,Medium,1,88,61,27,64,63,1
2023,1,Asir Region,Manufacture of essential pharmaceutical products and pharmaceutical preparations,Micro,7,3,3,0,20,20,0
2023,1,Asir Region,Manufacture of essential pharmaceutical products and pharmaceutical preparations,Medium,1,17,4,13,37,30,7
2023,1,Makkah Region,Manufacture of essential pharmaceutical products and pharmaceutical preparations,Small,16,105,67,38,141,135,6
2023,1,Makkah Region,Manufacture of essential pharmaceutical products and pharmaceutical preparations,Large,2,611,317,294,671,652,19
2023,1,Makkah Region,Manufacture of essential pharmaceutical products and pharmaceutical preparations,Micro,33,19,10,9,53,52,1
2023,1,Makkah Region,Manufacture of essential pharmaceutical products and pharmaceutical preparations,Medium,7,322,175,147,503,481,22
2023,1,Najran Region,Manufacture of essential pharmaceutical products and pharmaceutical preparations,Small,1,2,0,2,21,21,0
2023,1,Najran Region,Manufacture of essential pharmaceutical products and pharmaceutical preparations,Micro,3,0,0,0,8,8,0
2023,1,Eastern Region,Manufacture of leather goods and related products,Small,8,14,7,7,151,151,0
2023,1,Eastern Region,Manufacture of leather goods and related products,Micro,15,3,2,1,32,32,0
2023,1,Eastern Region,Manufacture of leather goods and related products,Medium,1,50,50,0,90,90,0
2023,1,Al-Jawf Region,Manufacture of leather goods and related products,Micro,2,1,1,0,6,6,0
2023,1,Northern border Region,Manufacture of leather goods and related products,Small,1,0,0,0,8,8,0
2023,1,Northern border Region,Manufacture of leather goods and related products,Micro,7,1,0,1,16,16,0
2023,1,Riyadh Region,Manufacture of leather goods and related products,Small,38,44,21,23,408,405,3
2023,1,Riyadh Region,Manufacture of leather goods and related products,Large,2,154,34,120,622,620,2
2023,1,Riyadh Region,Manufacture of leather goods and related products,Micro,77,9,6,3,203,203,0
2023,1,Riyadh Region,Manufacture of leather goods and related products,Medium,6,167,52,115,682,679,3
2023,1,Qassim Region,Manufacture of leather goods and related products,Small,1,1,0,1,8,8,0
2023,1,Qassim Region,Manufacture of leather goods and related products,Micro,7,1,0,1,15,15,0
2023,1,Medina Region,Manufacture of leather goods and related products,Small,2,1,0,1,17,17,0
2023,1,Medina Region,Manufacture of leather goods and related products,Micro,9,2,1,1,23,22,1
2023,1,Medina Region,Manufacture of leather goods and related products,Medium,1,11,4,7,48,48,0
2023,1,Tabuk Region,Manufacture of leather goods and related products,Micro,1,0,0,0,1,1,0
2023,1,Jazan Region,Manufacture of leather goods and related products,Micro,53,2,1,1,176,176,0
2023,1,Hail Region,Manufacture of leather goods and related products,Small,2,0,0,0,12,12,0
2023,1,Hail Region,Manufacture of leather goods and related products,Micro,7,0,0,0,20,20,0
2023,1,Asir Region,Manufacture of leather goods and related products,Small,1,0,0,0,7,7,0
2023,1,Asir Region,Manufacture of leather goods and related products,Micro,9,2,2,0,22,22,0
2023,1,Makkah Region,Manufacture of leather goods and related products,Small,8,36,13,23,145,144,1
2023,1,Makkah Region,Manufacture of leather goods and related products,Micro,30,4,2,2,76,76,0
2023,1,Makkah Region,Manufacture of leather goods and related products,Medium,1,13,7,6,39,39,0
2023,1,Najran Region,Manufacture of leather goods and related products,Micro,3,0,0,0,5,5,0
2023,1,Eastern Region,Manufacture of clothing,Small,239,554,210,344,2247,1999,248
2023,1,Eastern Region,Manufacture of clothing,Micro,2304,328,124,204,4978,4690,288
2023,1,Eastern Region,Manufacture of clothing,Medium,13,394,83,311,977,971,6
2023,1,Al Bahah Region,Manufacture of clothing,Small,13,17,7,10,113,91,22
2023,1,Al Bahah Region,Manufacture of clothing,Micro,156,27,13,14,287,255,32
2023,1,Al-Jawf Region,Manufacture of clothing,Small,13,12,6,6,85,68,17
2023,1,Al-Jawf Region,Manufacture of clothing,Micro,296,24,11,13,621,584,37
2023,1,Northern border Region,Manufacture of clothing,Small,4,9,4,5,25,14,11
2023,1,Northern border Region,Manufacture of clothing,Micro,286,17,8,9,709,674,35
2023,1,Riyadh Region,Manufacture of clothing,Small,437,1085,332,753,4278,3855,423
2023,1,Riyadh Region,Manufacture of clothing,Large,5,533,110,423,1836,1808,28
2023,1,Riyadh Region,Manufacture of clothing,Micro,3865,613,210,403,8307,7665,642
2023,1,Riyadh Region,Manufacture of clothing,Medium,34,863,271,592,2446,2253,193
2023,1,Qassim Region,Manufacture of clothing,Small,36,66,28,38,270,226,44
2023,1,Qassim Region,Manufacture of clothing,Micro,828,85,43,42,1716,1602,114
2023,1,Qassim Region,Manufacture of clothing,Medium,4,97,67,30,291,290,1
2023,1,Medina Region,Manufacture of clothing,Small,50,69,29,40,381,320,61
2023,1,Medina Region,Manufacture of clothing,Micro,1084,142,60,82,2303,2053,250
2023,1,Medina Region,Manufacture of clothing,Medium,4,118,47,71,334,326,8
2023,1,Tabuk Region,Manufacture of clothing,Small,20,37,15,22,195,184,11
2023,1,Tabuk Region,Manufacture of clothing,Micro,812,60,24,36,2133,2096,37
2023,1,Tabuk Region,Manufacture of clothing,Medium,1,0,0,0,89,89,0
2023,1,Jazan Region,Manufacture of clothing,Small,23,56,19,37,158,143,15
2023,1,Jazan Region,Manufacture of clothing,Micro,657,60,26,34,1403,1292,111
2023,1,Hail Region,Manufacture of clothing,Small,24,38,9,29,235,226,9
2023,1,Hail Region,Manufacture of clothing,Large,1,43,8,35,300,300,0
2023,1,Hail Region,Manufacture of clothing,Micro,416,40,14,26,874,794,80
2023,1,Asir Region,Manufacture of clothing,Small,51,91,40,51,429,404,25
2023,1,Asir Region,Manufacture of clothing,Micro,1052,126,55,71,2223,2029,194
2023,1,Asir Region,Manufacture of clothing,Medium,3,46,23,23,183,183,0
2023,1,Makkah Region,Manufacture of clothing,Small,198,507,150,357,1868,1652,216
2023,1,Makkah Region,Manufacture of clothing,Large,2,231,55,176,606,606,0
2023,1,Makkah Region,Manufacture of clothing,Micro,2980,419,166,253,6309,5745,564
2023,1,Makkah Region,Manufacture of clothing,Medium,21,445,115,330,1244,1239,5
2023,1,Najran Region,Manufacture of clothing,Small,20,32,9,23,160,155,5
2023,1,Najran Region,Manufacture of clothing,Micro,417,27,9,18,932,867,65
2023,1,Najran Region,Manufacture of clothing,Medium,1,22,5,17,47,47,0
2023,1,Eastern Region,Manufacture of electrical equipment,Small,58,335,233,102,955,949,6
2023,1,Eastern Region,Manufacture of electrical equipment,Large,9,2210,2090,120,1937,1931,6
2023,1,Eastern Region,Manufacture of electrical equipment,Micro,117,44,27,17,249,249,0
2023,1,Eastern Region,Manufacture of electrical equipment,Medium,27,830,628,202,1744,1742,2
2023,1,Al Bahah Region,Manufacture of electrical equipment,Micro,5,0,0,0,9,9,0
2023,1,Al-Jawf Region,Manufacture of electrical equipment,Small,1,1,1,0,5,5,0
2023,1,Al-Jawf Region,Manufacture of electrical equipment,Micro,13,1,1,0,18,18,0
2023,1,Northern border Region,Manufacture of electrical equipment,Micro,16,0,0,0,34,34,0
2023,1,Riyadh Region,Manufacture of electrical equipment,Small,91,393,191,202,1542,1534,8
2023,1,Riyadh Region,Manufacture of electrical equipment,Large,12,1179,937,242,2988,2983,5
2023,1,Riyadh Region,Manufacture of electrical equipment,Micro,163,54,29,25,352,352,0
2023,1,Riyadh Region,Manufacture of electrical equipment,Medium,51,1482,911,571,3988,3977,11
2023,1,Qassim Region,Manufacture of electrical equipment,Small,15,34,17,17,194,193,1
2023,1,Qassim Region,Manufacture of electrical equipment,Micro,24,3,3,0,47,47,0
2023,1,Qassim Region,Manufacture of electrical equipment,Medium,2,24,13,11,128,128,0
2023,1,Medina Region,Manufacture of electrical equipment,Small,11,52,36,16,155,153,2
2023,1,Medina Region,Manufacture of electrical equipment,Large,1,112,103,9,300,300,0
2023,1,Medina Region,Manufacture of electrical equipment,Micro,40,5,4,1,75,75,0
2023,1,Medina Region,Manufacture of electrical equipment,Medium,2,71,39,32,244,244,0
2023,1,Tabuk Region,Manufacture of electrical equipment,Small,1,3,0,3,7,7,0
2023,1,Tabuk Region,Manufacture of electrical equipment,Micro,8,0,0,0,16,16,0
2023,1,Jazan Region,Manufacture of electrical equipment,Micro,28,1,1,0,77,77,0
2023,1,Hail Region,Manufacture of electrical equipment,Small,2,6,4,2,11,11,0
2023,1,Hail Region,Manufacture of electrical equipment,Micro,12,3,1,2,37,37,0
2023,1,Hail Region,Manufacture of electrical equipment,Medium,1,37,13,24,91,91,0
2023,1,Asir Region,Manufacture of electrical equipment,Small,5,8,6,2,32,32,0
2023,1,Asir Region,Manufacture of electrical equipment,Micro,27,5,3,2,55,55,0
2023,1,Asir Region,Manufacture of electrical equipment,Medium,2,29,11,18,87,87,0
2023,1,Makkah Region,Manufacture of electrical equipment,Small,45,195,108,87,744,742,2
2023,1,Makkah Region,Manufacture of electrical equipment,Large,2,292,269,23,837,836,1
2023,1,Makkah Region,Manufacture of electrical equipment,Micro,136,29,21,8,269,263,6
2023,1,Makkah Region,Manufacture of electrical equipment,Medium,10,247,163,84,804,801,3
2023,1,Najran Region,Manufacture of electrical equipment,Small,2,5,3,2,30,30,0
2023,1,Najran Region,Manufacture of electrical equipment,Micro,7,2,0,2,15,15,0
2023,1,Eastern Region,Beverage making,Small,23,81,43,38,359,358,1
2023,1,Eastern Region,Beverage making,Large,4,577,379,198,1501,1500,1
2023,1,Eastern Region,Beverage making,Micro,35,9,5,4,64,63,1
2023,1,Eastern Region,Beverage making,Medium,6,160,65,95,488,485,3
2023,1,Al Bahah Region,Beverage making,Small,3,12,9,3,57,57,0
2023,1,Al Bahah Region,Beverage making,Micro,3,1,0,1,6,6,0
2023,1,Al Bahah Region,Beverage making,Medium,2,70,11,59,180,180,0
2023,1,Al-Jawf Region,Beverage making,Small,3,5,2,3,17,17,0
2023,1,Al-Jawf Region,Beverage making,Micro,5,1,1,0,9,9,0
2023,1,Al-Jawf Region,Beverage making,Medium,1,16,9,7,50,50,0
2023,1,Northern border Region,Beverage making,Small,1,3,2,1,12,12,0
2023,1,Riyadh Region,Beverage making,Small,37,172,84,88,572,572,0
2023,1,Riyadh Region,Beverage making,Large,12,1974,1324,650,4667,4659,8
2023,1,Riyadh Region,Beverage making,Micro,77,26,12,14,160,160,0
2023,1,Riyadh Region,Beverage making,Medium,33,938,366,572,2685,2680,5
2023,1,Qassim Region,Beverage making,Small,9,35,15,20,135,135,0
2023,1,Qassim Region,Beverage making,Large,2,384,176,208,779,779,0
2023,1,Qassim Region,Beverage making,Micro,13,2,1,1,22,22,0
2023,1,Qassim Region,Beverage making,Medium,4,155,46,109,437,437,0
2023,1,Medina Region,Beverage making,Small,13,69,38,31,233,232,1
2023,1,Medina Region,Beverage making,Micro,15,4,2,2,27,27,0
2023,1,Medina Region,Beverage making,Medium,6,196,77,119,556,555,1
2023,1,Tabuk Region,Beverage making,Small,4,20,12,8,74,74,0
2023,1,Tabuk Region,Beverage making,Micro,15,4,4,0,38,38,0
2023,1,Tabuk Region,Beverage making,Medium,2,75,41,34,151,151,0
2023,1,Jazan Region,Beverage making,Small,8,21,8,13,89,89,0
2023,1,Jazan Region,Beverage making,Large,1,61,45,16,196,196,0
2023,1,Jazan Region,Beverage making,Micro,21,4,3,1,50,50,0
2023,1,Jazan Region,Beverage making,Medium,5,188,113,75,575,575,0
2023,1,Hail Region,Beverage making,Small,5,21,14,7,66,66,0
2023,1,Hail Region,Beverage making,Large,1,131,50,81,261,259,2
2023,1,Hail Region,Beverage making,Micro,6,2,2,0,8,8,0
2023,1,Hail Region,Beverage making,Medium,1,16,8,8,44,43,1
2023,1,Asir Region,Beverage making,Small,12,37,29,8,198,198,0
2023,1,Asir Region,Beverage making,Large,1,141,122,19,310,310,0
2023,1,Asir Region,Beverage making,Micro,21,3,1,2,48,48,0
2023,1,Asir Region,Beverage making,Medium,2,57,34,23,125,125,0
2023,1,Makkah Region,Beverage making,Small,41,190,87,103,651,648,3
2023,1,Makkah Region,Beverage making,Large,7,1258,924,334,2511,2505,6
2023,1,Makkah Region,Beverage making,Micro,98,29,18,11,188,187,1
2023,1,Makkah Region,Beverage making,Medium,25,645,347,298,1917,1913,4
2023,1,Najran Region,Beverage making,Small,2,17,5,12,67,67,0
2023,1,Najran Region,Beverage making,Micro,5,0,0,0,11,11,0
2023,1,Najran Region,Beverage making,Medium,2,115,95,20,250,250,0
2023,1,Eastern Region,Manufacture of basic metals,Small,96,474,306,168,1509,1508,1
2023,1,Eastern Region,Manufacture of basic metals,Large,20,2875,2616,259,5160,5158,2
2023,1,Eastern Region,Manufacture of basic metals,Micro,108,50,40,10,200,200,0
2023,1,Eastern Region,Manufacture of basic metals,Medium,61,2036,1428,608,4860,4859,1
2023,1,Al Bahah Region,Manufacture of basic metals,Micro,10,1,1,0,18,18,0
2023,1,Al-Jawf Region,Manufacture of basic metals,Small,2,0,0,0,12,12,0
2023,1,Al-Jawf Region,Manufacture of basic metals,Micro,15,4,4,0,36,36,0
2023,1,Northern border Region,Manufacture of basic metals,Micro,10,3,3,0,23,23,0
2023,1,Riyadh Region,Manufacture of basic metals,Small,180,698,334,364,2563,2547,16
2023,1,Riyadh Region,Manufacture of basic metals,Large,11,1092,711,381,2931,2925,6
2023,1,Riyadh Region,Manufacture of basic metals,Micro,337,74,37,37,754,752,2
2023,1,Riyadh Region,Manufacture of basic metals,Medium,62,1559,904,655,4896,4864,32
2023,1,Qassim Region,Manufacture of basic metals,Small,13,30,22,8,234,233,1
2023,1,Qassim Region,Manufacture of basic metals,Micro,65,8,4,4,126,125,1
2023,1,Qassim Region,Manufacture of basic metals,Medium,6,60,38,22,335,335,0
2023,1,Medina Region,Manufacture of basic metals,Small,10,32,19,13,150,149,1
2023,1,Medina Region,Manufacture of basic metals,Micro,49,8,3,5,116,116,0
2023,1,Medina Region,Manufacture of basic metals,Medium,3,261,213,48,321,321,0
2023,1,Tabuk Region,Manufacture of basic metals,Small,5,2,1,1,38,38,0
2023,1,Tabuk Region,Manufacture of basic metals,Micro,10,2,1,1,19,19,0
2023,1,Tabuk Region,Manufacture of basic metals,Medium,2,81,30,51,208,208,0
2023,1,Jazan Region,Manufacture of basic metals,Small,2,8,4,4,28,28,0
2023,1,Jazan Region,Manufacture of basic metals,Large,1,150,150,0,115,115,0
2023,1,Jazan Region,Manufacture of basic metals,Micro,36,5,3,2,85,85,0
2023,1,Jazan Region,Manufacture of basic metals,Medium,2,102,88,14,244,244,0
2023,1,Hail Region,Manufacture of basic metals,Small,2,3,2,1,13,13,0
2023,1,Hail Region,Manufacture of basic metals,Micro,36,4,1,3,81,81,0
2023,1,Hail Region,Manufacture of basic metals,Medium,2,23,8,15,96,96,0
2023,1,Asir Region,Manufacture of basic metals,Small,17,46,34,12,198,197,1
2023,1,Asir Region,Manufacture of basic metals,Micro,66,6,2,4,135,135,0
2023,1,Asir Region,Manufacture of basic metals,Medium,2,56,55,1,153,153,0
2023,1,Makkah Region,Manufacture of basic metals,Small,88,372,205,167,1427,1419,8
2023,1,Makkah Region,Manufacture of basic metals,Large,12,1413,881,532,3129,3126,3
2023,1,Makkah Region,Manufacture of basic metals,Micro,174,71,37,34,376,373,3
2023,1,Makkah Region,Manufacture of basic metals,Medium,32,997,678,319,2610,2600,10
2023,1,Najran Region,Manufacture of basic metals,Small,1,3,0,3,10,10,0
2023,1,Najran Region,Manufacture of basic metals,Large,1,221,218,3,360,360,0
2023,1,Najran Region,Manufacture of basic metals,Micro,38,5,2,3,69,69,0
2023,1,Najran Region,Manufacture of basic metals,Medium,1,31,15,16,107,107,0
2023,1,Eastern Region,"Manufacture of wood, wood and cork products, except furniture, manufacture of straw and plaiting materials",Small,182,489,256,233,2065,2054,11
2023,1,Eastern Region,"Manufacture of wood, wood and cork products, except furniture, manufacture of straw and plaiting materials",Large,1,61,61,0,249,249,0
2023,1,Eastern Region,"Manufacture of wood, wood and cork products, except furniture, manufacture of straw and plaiting materials",Micro,419,166,66,100,993,990,3
2023,1,Eastern Region,"Manufacture of wood, wood and cork products, except furniture, manufacture of straw and plaiting materials",Medium,15,396,236,160,1253,1250,3
2023,1,Al Bahah Region,"Manufacture of wood, wood and cork products, except furniture, manufacture of straw and plaiting materials",Small,11,21,12,9,74,74,0
2023,1,Al Bahah Region,"Manufacture of wood, wood and cork products, except furniture, manufacture of straw and plaiting materials",Micro,86,19,12,7,205,204,1
2023,1,Al Bahah Region,"Manufacture of wood, wood and cork products, except furniture, manufacture of straw and plaiting materials",Medium,1,40,36,4,146,146,0
2023,1,Al-Jawf Region,"Manufacture of wood, wood and cork products, except furniture, manufacture of straw and plaiting materials",Small,13,16,6,10,88,88,0
2023,1,Al-Jawf Region,"Manufacture of wood, wood and cork products, except furniture, manufacture of straw and plaiting materials",Micro,86,12,7,5,178,177,1
2023,1,Northern border Region,"Manufacture of wood, wood and cork products, except furniture, manufacture of straw and plaiting materials",Small,2,4,4,0,10,10,0
2023,1,Northern border Region,"Manufacture of wood, wood and cork products, except furniture, manufacture of straw and plaiting materials",Micro,49,5,1,4,108,108,0
2023,1,Riyadh Region,"Manufacture of wood, wood and cork products, except furniture, manufacture of straw and plaiting materials",Small,299,756,274,482,3418,3392,26
2023,1,Riyadh Region,"Manufacture of wood, wood and cork products, except furniture, manufacture of straw and plaiting materials",Micro,966,276,104,172,2266,2257,9
2023,1,Riyadh Region,"Manufacture of wood, wood and cork products, except furniture, manufacture of straw and plaiting materials",Medium,34,853,286,567,2542,2467,75
2023,1,Qassim Region,"Manufacture of wood, wood and cork products, except furniture, manufacture of straw and plaiting materials",Small,27,74,35,39,312,312,0
2023,1,Qassim Region,"Manufacture of wood, wood and cork products, except furniture, manufacture of straw and plaiting materials",Large,1,67,44,23,202,202,0
2023,1,Qassim Region,"Manufacture of wood, wood and cork products, except furniture, manufacture of straw and plaiting materials",Micro,266,49,23,26,654,654,0
2023,1,Qassim Region,"Manufacture of wood, wood and cork products, except furniture, manufacture of straw and plaiting materials",Medium,2,28,13,15,121,121,0
2023,1,Medina Region,"Manufacture of wood, wood and cork products, except furniture, manufacture of straw and plaiting materials",Small,25,67,40,27,259,259,0
2023,1,Medina Region,"Manufacture of wood, wood and cork products, except furniture, manufacture of straw and plaiting materials",Micro,161,34,21,13,391,391,0
2023,1,Medina Region,"Manufacture of wood, wood and cork products, except furniture, manufacture of straw and plaiting materials",Medium,2,36,20,16,91,91,0
2023,1,Tabuk Region,"Manufacture of wood, wood and cork products, except furniture, manufacture of straw and plaiting materials",Small,13,19,9,10,80,80,0
2023,1,Tabuk Region,"Manufacture of wood, wood and cork products, except furniture, manufacture of straw and plaiting materials",Micro,91,9,4,5,212,212,0
2023,1,Jazan Region,"Manufacture of wood, wood and cork products, except furniture, manufacture of straw and plaiting materials",Small,12,13,9,4,84,83,1
2023,1,Jazan Region,"Manufacture of wood, wood and cork products, except furniture, manufacture of straw and plaiting materials",Micro,210,23,11,12,518,516,2
2023,1,Jazan Region,"Manufacture of wood, wood and cork products, except furniture, manufacture of straw and plaiting materials",Medium,2,31,5,26,134,134,0
2023,1,Hail Region,"Manufacture of wood, wood and cork products, except furniture, manufacture of straw and plaiting materials",Small,10,17,10,7,102,102,0
2023,1,Hail Region,"Manufacture of wood, wood and cork products, except furniture, manufacture of straw and plaiting materials",Micro,56,14,6,8,127,127,0
2023,1,Asir Region,"Manufacture of wood, wood and cork products, except furniture, manufacture of straw and plaiting materials",Small,34,68,39,29,355,354,1
2023,1,Asir Region,"Manufacture of wood, wood and cork products, except furniture, manufacture of straw and plaiting materials",Micro,299,59,23,36,688,686,2
2023,1,Asir Region,"Manufacture of wood, wood and cork products, except furniture, manufacture of straw and plaiting materials",Medium,1,12,5,7,43,43,0
2023,1,Makkah Region,"Manufacture of wood, wood and cork products, except furniture, manufacture of straw and plaiting materials",Small,129,376,154,222,1478,1472,6
2023,1,Makkah Region,"Manufacture of wood, wood and cork products, except furniture, manufacture of straw and plaiting materials",Large,2,181,147,34,564,564,0
2023,1,Makkah Region,"Manufacture of wood, wood and cork products, except furniture, manufacture of straw and plaiting materials",Micro,703,148,74,74,1613,1604,9
2023,1,Makkah Region,"Manufacture of wood, wood and cork products, except furniture, manufacture of straw and plaiting materials",Medium,13,348,168,180,979,970,9
2023,1,Najran Region,"Manufacture of wood, wood and cork products, except furniture, manufacture of straw and plaiting materials",Small,2,4,1,3,10,10,0
2023,1,Najran Region,"Manufacture of wood, wood and cork products, except furniture, manufacture of straw and plaiting materials",Micro,86,7,3,4,202,202,0
2023,1,Eastern Region,"Manufacture of computers, electronic and optical products",Small,20,120,84,36,297,297,0
2023,1,Eastern Region,"Manufacture of computers, electronic and optical products",Micro,46,24,16,8,76,74,2
2023,1,Eastern Region,"Manufacture of computers, electronic and optical products",Medium,5,168,105,63,350,350,0
2023,1,Al Bahah Region,"Manufacture of computers, electronic and optical products",Micro,7,5,5,0,8,8,0
2023,1,Al-Jawf Region,"Manufacture of computers, electronic and optical products",Micro,4,0,0,0,12,12,0
2023,1,Northern border Region,"Manufacture of computers, electronic and optical products",Micro,4,1,1,0,6,6,0
2023,1,Riyadh Region,"Manufacture of computers, electronic and optical products",Small,26,116,80,36,323,319,4
2023,1,Riyadh Region,"Manufacture of computers, electronic and optical products",Micro,71,35,16,19,129,129,0
2023,1,Riyadh Region,"Manufacture of computers, electronic and optical products",Medium,3,63,28,35,153,152,1
2023,1,Qassim Region,"Manufacture of computers, electronic and optical products",Micro,7,0,0,0,12,12,0
2023,1,Medina Region,"Manufacture of computers, electronic and optical products",Small,5,19,17,2,32,32,0
2023,1,Medina Region,"Manufacture of computers, electronic and optical products",Micro,13,2,1,1,26,26,0
2023,1,Tabuk Region,"Manufacture of computers, electronic and optical products",Micro,11,1,0,1,16,16,0
2023,1,Jazan Region,"Manufacture of computers, electronic and optical products",Small,1,0,0,0,17,17,0
2023,1,Jazan Region,"Manufacture of computers, electronic and optical products",Micro,19,2,2,0,33,33,0
2023,1,Hail Region,"Manufacture of computers, electronic and optical products",Micro,7,0,0,0,16,16,0
2023,1,Asir Region,"Manufacture of computers, electronic and optical products",Small,2,3,2,1,10,10,0
2023,1,Asir Region,"Manufacture of computers, electronic and optical products",Micro,37,1,1,0,71,71,0
2023,1,Makkah Region,"Manufacture of computers, electronic and optical products",Small,20,44,25,19,180,177,3
2023,1,Makkah Region,"Manufacture of computers, electronic and optical products",Large,1,88,83,5,176,176,0
2023,1,Makkah Region,"Manufacture of computers, electronic and optical products",Micro,122,54,32,22,216,216,0
2023,1,Makkah Region,"Manufacture of computers, electronic and optical products",Medium,2,65,47,18,80,77,3
2023,1,Najran Region,"Manufacture of computers, electronic and optical products",Micro,5,1,0,1,14,14,0
2023,1,Eastern Region,Furniture making,Small,163,525,244,281,2203,2195,8
2023,1,Eastern Region,Furniture making,Large,3,128,70,58,705,702,3
2023,1,Eastern Region,Furniture making,Micro,543,115,49,66,1329,1327,2
2023,1,Eastern Region,Furniture making,Medium,30,698,353,345,2121,2113,8
2023,1,Al Bahah Region,Furniture making,Small,9,5,4,1,87,87,0
2023,1,Al Bahah Region,Furniture making,Micro,94,10,6,4,242,242,0
2023,1,Al-Jawf Region,Furniture making,Small,7,11,8,3,55,55,0
2023,1,Al-Jawf Region,Furniture making,Micro,124,13,7,6,267,266,1
2023,1,Northern border Region,Furniture making,Small,4,9,7,2,34,34,0
2023,1,Northern border Region,Furniture making,Micro,94,13,8,5,241,241,0
2023,1,Riyadh Region,Furniture making,Small,440,1151,436,715,5722,5703,19
2023,1,Riyadh Region,Furniture making,Large,11,978,415,563,3346,3339,7
2023,1,Riyadh Region,Furniture making,Micro,1449,209,86,123,3536,3524,12
2023,1,Riyadh Region,Furniture making,Medium,89,2088,807,1281,6666,6633,33
2023,1,Qassim Region,Furniture making,Small,60,127,80,47,663,659,4
2023,1,Qassim Region,Furniture making,Large,1,79,25,54,346,346,0
2023,1,Qassim Region,Furniture making,Micro,215,28,20,8,542,541,1
2023,1,Qassim Region,Furniture making,Medium,10,145,85,60,605,605,0
2023,1,Medina Region,Furniture making,Small,39,51,30,21,398,395,3
2023,1,Medina Region,Furniture making,Micro,277,46,27,19,639,637,2
2023,1,Medina Region,Furniture making,Medium,1,16,13,3,36,36,0
2023,1,Tabuk Region,Furniture making,Small,21,12,4,8,170,170,0
2023,1,Tabuk Region,Furniture making,Micro,222,18,10,8,593,588,5
2023,1,Jazan Region,Furniture making,Small,21,14,9,5,161,160,1
2023,1,Jazan Region,Furniture making,Micro,399,32,16,16,1107,1101,6
2023,1,Hail Region,Furniture making,Small,20,42,26,16,226,225,1
2023,1,Hail Region,Furniture making,Micro,153,15,9,6,362,362,0
2023,1,Asir Region,Furniture making,Small,67,128,69,59,695,694,1
2023,1,Asir Region,Furniture making,Micro,566,63,46,17,1354,1351,3
2023,1,Asir Region,Furniture making,Medium,4,68,37,31,177,177,0
2023,1,Makkah Region,Furniture making,Small,115,222,114,108,1268,1261,7
2023,1,Makkah Region,Furniture making,Large,1,77,51,26,270,269,1
2023,1,Makkah Region,Furniture making,Micro,739,108,50,58,1765,1757,8
2023,1,Makkah Region,Furniture making,Medium,32,871,335,536,2650,2635,15
2023,1,Najran Region,Furniture making,Small,15,33,11,22,179,179,0
2023,1,Najran Region,Furniture making,Micro,109,15,6,9,284,284,0
2023,1,Najran Region,Furniture making,Medium,3,82,21,61,267,267,0
2023,1,Eastern Region,Manufacture of other transportation equipment,Small,5,22,7,15,61,60,1
2023,1,Eastern Region,Manufacture of other transportation equipment,Large,3,2928,2854,74,785,785,0
2023,1,Eastern Region,Manufacture of other transportation equipment,Micro,12,5,3,2,22,22,0
2023,1,Eastern Region,Manufacture of other transportation equipment,Medium,3,49,42,7,161,161,0
2023,1,Al Bahah Region,Manufacture of other transportation equipment,Micro,1,0,0,0,1,1,0
2023,1,Al-Jawf Region,Manufacture of other transportation equipment,Micro,1,0,0,0,1,1,0
2023,1,Northern border Region,Manufacture of other transportation equipment,Micro,1,0,0,0,3,3,0
2023,1,Riyadh Region,Manufacture of other transportation equipment,Small,14,97,74,23,157,155,2
2023,1,Riyadh Region,Manufacture of other transportation equipment,Large,2,1314,1261,53,767,767,0
2023,1,Riyadh Region,Manufacture of other transportation equipment,Micro,66,21,8,13,144,143,1
2023,1,Riyadh Region,Manufacture of other transportation equipment,Medium,5,183,103,80,259,259,0
2023,1,Qassim Region,Manufacture of other transportation equipment,Micro,1,0,0,0,1,1,0
2023,1,Medina Region,Manufacture of other transportation equipment,Small,2,1,1,0,16,16,0
2023,1,Medina Region,Manufacture of other transportation equipment,Micro,8,2,2,0,12,12,0
2023,1,Tabuk Region,Manufacture of other transportation equipment,Micro,1,1,0,1,1,1,0
2023,1,Jazan Region,Manufacture of other transportation equipment,Small,1,7,6,1,30,30,0
2023,1,Jazan Region,Manufacture of other transportation equipment,Micro,5,0,0,0,16,16,0
2023,1,Hail Region,Manufacture of other transportation equipment,Micro,1,0,0,0,3,3,0
2023,1,Asir Region,Manufacture of other transportation equipment,Micro,5,1,1,0,14,14,0
2023,1,Makkah Region,Manufacture of other transportation equipment,Small,5,54,13,41,84,78,6
2023,1,Makkah Region,Manufacture of other transportation equipment,Micro,28,8,5,3,59,57,2
2023,1,Makkah Region,Manufacture of other transportation equipment,Medium,3,19,13,6,161,161,0
2023,1,Najran Region,Manufacture of other transportation equipment,Small,1,0,0,0,6,6,0
2023,1,Najran Region,Manufacture of other transportation equipment,Micro,3,1,0,1,6,6,0
2023,1,Eastern Region,"Manufacture of motor vehicles, trailers and semi-trailers",Small,26,148,91,57,408,408,0
2023,1,Eastern Region,"Manufacture of motor vehicles, trailers and semi-trailers",Large,2,298,282,16,807,807,0
2023,1,Eastern Region,"Manufacture of motor vehicles, trailers and semi-trailers",Micro,29,8,6,2,68,68,0
2023,1,Eastern Region,"Manufacture of motor vehicles, trailers and semi-trailers",Medium,10,358,270,88,1005,1004,1
2023,1,Al Bahah Region,"Manufacture of motor vehicles, trailers and semi-trailers",Micro,2,0,0,0,3,3,0
2023,1,Al-Jawf Region,"Manufacture of motor vehicles, trailers and semi-trailers",Small,1,2,2,0,8,8,0
2023,1,Al-Jawf Region,"Manufacture of motor vehicles, trailers and semi-trailers",Micro,9,1,1,0,18,18,0
2023,1,Northern border Region,"Manufacture of motor vehicles, trailers and semi-trailers",Micro,1,0,0,0,2,2,0
2023,1,Riyadh Region,"Manufacture of motor vehicles, trailers and semi-trailers",Small,35,163,94,69,626,625,1
2023,1,Riyadh Region,"Manufacture of motor vehicles, trailers and semi-trailers",Large,2,204,68,136,944,940,4
2023,1,Riyadh Region,"Manufacture of motor vehicles, trailers and semi-trailers",Micro,59,23,11,12,131,130,1
2023,1,Riyadh Region,"Manufacture of motor vehicles, trailers and semi-trailers",Medium,14,330,132,198,857,849,8
2023,1,Qassim Region,"Manufacture of motor vehicles, trailers and semi-trailers",Small,9,48,28,20,141,141,0
2023,1,Qassim Region,"Manufacture of motor vehicles, trailers and semi-trailers",Large,1,101,79,22,259,259,0
2023,1,Qassim Region,"Manufacture of motor vehicles, trailers and semi-trailers",Micro,11,1,1,0,29,29,0
2023,1,Medina Region,"Manufacture of motor vehicles, trailers and semi-trailers",Small,2,1,1,0,21,21,0
2023,1,Medina Region,"Manufacture of motor vehicles, trailers and semi-trailers",Micro,14,2,0,2,32,32,0
2023,1,Tabuk Region,"Manufacture of motor vehicles, trailers and semi-trailers",Small,1,11,3,8,27,27,0
2023,1,Tabuk Region,"Manufacture of motor vehicles, trailers and semi-trailers",Micro,5,3,2,1,19,19,0
2023,1,Jazan Region,"Manufacture of motor vehicles, trailers and semi-trailers",Small,1,4,1,3,17,17,0
2023,1,Jazan Region,"Manufacture of motor vehicles, trailers and semi-trailers",Micro,12,1,1,0,33,33,0
2023,1,Hail Region,"Manufacture of motor vehicles, trailers and semi-trailers",Small,1,0,0,0,6,6,0
2023,1,Hail Region,"Manufacture of motor vehicles, trailers and semi-trailers",Micro,5,1,1,0,10,10,0
2023,1,Asir Region,"Manufacture of motor vehicles, trailers and semi-trailers",Small,1,1,0,1,5,5,0
2023,1,Asir Region,"Manufacture of motor vehicles, trailers and semi-trailers",Micro,9,2,1,1,18,18,0
2023,1,Makkah Region,"Manufacture of motor vehicles, trailers and semi-trailers",Small,15,60,44,16,176,176,0
2023,1,Makkah Region,"Manufacture of motor vehicles, trailers and semi-trailers",Large,1,85,66,19,220,220,0
2023,1,Makkah Region,"Manufacture of motor vehicles, trailers and semi-trailers",Micro,41,10,7,3,97,97,0
2023,1,Makkah Region,"Manufacture of motor vehicles, trailers and semi-trailers",Medium,9,415,279,136,788,788,0
2023,1,Najran Region,"Manufacture of motor vehicles, trailers and semi-trailers",Micro,8,1,0,1,13,13,0
2023,1,Eastern Region,Manufacture of machinery and equipment not classified elsewhere,Small,72,526,379,147,1130,1128,2
2023,1,Eastern Region,Manufacture of machinery and equipment not classified elsewhere,Large,7,1599,1467,132,2101,2099,2
2023,1,Eastern Region,Manufacture of machinery and equipment not classified elsewhere,Micro,67,30,19,11,127,126,1
2023,1,Eastern Region,Manufacture of machinery and equipment not classified elsewhere,Medium,37,1519,1282,237,2365,2361,4
2023,1,Al Bahah Region,Manufacture of machinery and equipment not classified elsewhere,Small,1,1,0,1,5,5,0
2023,1,Al Bahah Region,Manufacture of machinery and equipment not classified elsewhere,Micro,6,4,3,1,9,9,0
2023,1,Al-Jawf Region,Manufacture of machinery and equipment not classified elsewhere,Micro,2,0,0,0,6,6,0
2023,1,Northern border Region,Manufacture of machinery and equipment not classified elsewhere,Micro,3,0,0,0,10,10,0
2023,1,Riyadh Region,Manufacture of machinery and equipment not classified elsewhere,Small,91,335,169,166,1436,1429,7
2023,1,Riyadh Region,Manufacture of machinery and equipment not classified elsewhere,Large,2,253,100,153,499,498,1
2023,1,Riyadh Region,Manufacture of machinery and equipment not classified elsewhere,Micro,274,63,36,27,616,611,5
2023,1,Riyadh Region,Manufacture of machinery and equipment not classified elsewhere,Medium,31,925,505,420,2743,2738,5
2023,1,Qassim Region,Manufacture of machinery and equipment not classified elsewhere,Small,4,8,5,3,32,32,0
2023,1,Qassim Region,Manufacture of machinery and equipment not classified elsewhere,Micro,31,4,3,1,61,61,0
2023,1,Qassim Region,Manufacture of machinery and equipment not classified elsewhere,Medium,3,72,33,39,209,209,0
2023,1,Medina Region,Manufacture of machinery and equipment not classified elsewhere,Small,5,31,17,14,82,81,1
2023,1,Medina Region,Manufacture of machinery and equipment not classified elsewhere,Micro,19,1,0,1,52,52,0
2023,1,Medina Region,Manufacture of machinery and equipment not classified elsewhere,Medium,4,58,34,24,237,237,0
2023,1,Tabuk Region,Manufacture of machinery and equipment not classified elsewhere,Micro,6,1,1,0,11,11,0
2023,1,Jazan Region,Manufacture of machinery and equipment not classified elsewhere,Small,2,2,1,1,21,21,0
2023,1,Jazan Region,Manufacture of machinery and equipment not classified elsewhere,Micro,18,1,0,1,46,46,0
2023,1,Hail Region,Manufacture of machinery and equipment not classified elsewhere,Small,1,16,16,0,3,3,0
2023,1,Hail Region,Manufacture of machinery and equipment not classified elsewhere,Micro,13,0,0,0,29,29,0
2023,1,Asir Region,Manufacture of machinery and equipment not classified elsewhere,Small,4,16,13,3,58,57,1
2023,1,Asir Region,Manufacture of machinery and equipment not classified elsewhere,Micro,17,2,1,1,30,30,0
2023,1,Asir Region,Manufacture of machinery and equipment not classified elsewhere,Medium,3,71,71,0,182,182,0
2023,1,Makkah Region,Manufacture of machinery and equipment not classified elsewhere,Small,37,145,70,75,512,510,2
2023,1,Makkah Region,Manufacture of machinery and equipment not classified elsewhere,Large,2,652,639,13,1073,1069,4
2023,1,Makkah Region,Manufacture of machinery and equipment not classified elsewhere,Micro,83,23,15,8,166,165,1
2023,1,Makkah Region,Manufacture of machinery and equipment not classified elsewhere,Medium,18,536,369,167,1319,1312,7
2023,1,Najran Region,Manufacture of machinery and equipment not classified elsewhere,Small,1,0,0,0,6,6,0
2023,1,Najran Region,Manufacture of machinery and equipment not classified elsewhere,Micro,10,1,0,1,27,27,0
2023,1,Najran Region,Manufacture of machinery and equipment not classified elsewhere,Medium,1,0,0,0,90,90,0
2023,1,Eastern Region,"Connecting electricity, gas, steam and air conditioning",Small,53,302,221,81,622,621,1
2023,1,Eastern Region,"Connecting electricity, gas, steam and air conditioning",Large,1,6016,6004,12,467,467,0
2023,1,Eastern Region,"Connecting electricity, gas, steam and air conditioning",Micro,62,38,21,17,123,121,2
2023,1,Eastern Region,"Connecting electricity, gas, steam and air conditioning",Medium,7,270,216,54,293,293,0
2023,1,Al Bahah Region,"Connecting electricity, gas, steam and air conditioning",Micro,4,3,3,0,8,8,0
2023,1,Al-Jawf Region,"Connecting electricity, gas, steam and air conditioning",Micro,6,1,1,0,10,10,0
2023,1,Northern border Region,"Connecting electricity, gas, steam and air conditioning",Micro,3,1,1,0,7,7,0
2023,1,Riyadh Region,"Connecting electricity, gas, steam and air conditioning",Small,70,359,202,157,795,791,4
2023,1,Riyadh Region,"Connecting electricity, gas, steam and air conditioning",Large,2,10490,10092,398,951,946,5
2023,1,Riyadh Region,"Connecting electricity, gas, steam and air conditioning",Micro,112,87,46,41,215,214,1
2023,1,Riyadh Region,"Connecting electricity, gas, steam and air conditioning",Medium,5,316,257,59,240,240,0
2023,1,Qassim Region,"Connecting electricity, gas, steam and air conditioning",Small,2,10,7,3,37,37,0
2023,1,Qassim Region,"Connecting electricity, gas, steam and air conditioning",Micro,13,1,1,0,38,38,0
2023,1,Qassim Region,"Connecting electricity, gas, steam and air conditioning",Medium,1,63,63,0,132,132,0
2023,1,Medina Region,"Connecting electricity, gas, steam and air conditioning",Small,3,34,34,0,16,16,0
2023,1,Medina Region,"Connecting electricity, gas, steam and air conditioning",Micro,20,8,3,5,38,38,0
2023,1,Medina Region,"Connecting electricity, gas, steam and air conditioning",Medium,1,95,95,0,2,2,0
2023,1,Tabuk Region,"Connecting electricity, gas, steam and air conditioning",Micro,13,3,0,3,25,25,0
2023,1,Jazan Region,"Connecting electricity, gas, steam and air conditioning",Small,3,23,17,6,46,46,0
2023,1,Jazan Region,"Connecting electricity, gas, steam and air conditioning",Micro,20,4,3,1,41,41,0
2023,1,Jazan Region,"Connecting electricity, gas, steam and air conditioning",Medium,2,7,7,0,137,137,0
2023,1,Hail Region,"Connecting electricity, gas, steam and air conditioning",Micro,9,5,4,1,21,21,0
2023,1,Asir Region,"Connecting electricity, gas, steam and air conditioning",Small,5,20,9,11,57,57,0
2023,1,Asir Region,"Connecting electricity, gas, steam and air conditioning",Large,1,4531,4531,0,248,248,0
2023,1,Asir Region,"Connecting electricity, gas, steam and air conditioning",Micro,23,7,3,4,46,46,0
2023,1,Asir Region,"Connecting electricity, gas, steam and air conditioning",Medium,3,164,159,5,150,150,0
2023,1,Makkah Region,"Connecting electricity, gas, steam and air conditioning",Small,29,179,100,79,479,479,0
2023,1,Makkah Region,"Connecting electricity, gas, steam and air conditioning",Large,2,9216,9215,1,627,627,0
2023,1,Makkah Region,"Connecting electricity, gas, steam and air conditioning",Micro,65,19,15,4,114,114,0
2023,1,Makkah Region,"Connecting electricity, gas, steam and air conditioning",Medium,5,169,129,40,301,300,1
2023,1,Najran Region,"Connecting electricity, gas, steam and air conditioning",Small,1,1,1,0,8,8,0
2023,1,Najran Region,"Connecting electricity, gas, steam and air conditioning",Micro,7,0,0,0,14,14,0
2023,1,Eastern Region,"Financing insurance, reinsurance and pension funds, excluding compulsory social security",Small,7,117,74,43,34,31,3
2023,1,Eastern Region,"Financing insurance, reinsurance and pension funds, excluding compulsory social security",Large,2,582,429,153,162,152,10
2023,1,Eastern Region,"Financing insurance, reinsurance and pension funds, excluding compulsory social security",Micro,2,4,2,2,2,2,0
2023,1,Eastern Region,"Financing insurance, reinsurance and pension funds, excluding compulsory social security",Medium,4,299,183,116,141,140,1
2023,1,Al Bahah Region,"Financing insurance, reinsurance and pension funds, excluding compulsory social security",Micro,1,0,0,0,4,4,0
2023,1,Riyadh Region,"Financing insurance, reinsurance and pension funds, excluding compulsory social security",Small,6,100,78,22,37,36,1
2023,1,Riyadh Region,"Financing insurance, reinsurance and pension funds, excluding compulsory social security",Large,7,3105,1907,1198,805,770,35
2023,1,Riyadh Region,"Financing insurance, reinsurance and pension funds, excluding compulsory social security",Micro,26,24,10,14,13,13,0
2023,1,Riyadh Region,"Financing insurance, reinsurance and pension funds, excluding compulsory social security",Medium,9,931,679,252,342,327,15
2023,1,Medina Region,"Financing insurance, reinsurance and pension funds, excluding compulsory social security",Micro,4,2,0,2,7,6,1
2023,1,Jazan Region,"Financing insurance, reinsurance and pension funds, excluding compulsory social security",Micro,1,1,1,0,2,2,0
2023,1,Asir Region,"Financing insurance, reinsurance and pension funds, excluding compulsory social security",Micro,1,0,0,0,1,1,0
2023,1,Makkah Region,"Financing insurance, reinsurance and pension funds, excluding compulsory social security",Small,10,167,102,65,49,48,1
2023,1,Makkah Region,"Financing insurance, reinsurance and pension funds, excluding compulsory social security",Large,1,860,443,417,381,312,69
2023,1,Makkah Region,"Financing insurance, reinsurance and pension funds, excluding compulsory social security",Micro,8,1,1,0,10,10,0
2023,1,Makkah Region,"Financing insurance, reinsurance and pension funds, excluding compulsory social security",Medium,5,626,393,233,224,215,9
2023,1,Najran Region,"Financing insurance, reinsurance and pension funds, excluding compulsory social security",Micro,2,0,0,0,5,5,0
2023,1,Eastern Region,Metal ore mining,Small,10,16,13,3,92,92,0
2023,1,Eastern Region,Metal ore mining,Large,1,570,566,4,3,3,0
2023,1,Eastern Region,Metal ore mining,Micro,55,18,12,6,115,115,0
2023,1,Eastern Region,Metal ore mining,Medium,1,77,65,12,54,53,1
2023,1,Al Bahah Region,Metal ore mining,Micro,4,0,0,0,5,5,0
2023,1,Al-Jawf Region,Metal ore mining,Micro,1,0,0,0,4,4,0
2023,1,Northern border Region,Metal ore mining,Micro,3,0,0,0,7,7,0
2023,1,Riyadh Region,Metal ore mining,Small,15,50,29,21,190,189,1
2023,1,Riyadh Region,Metal ore mining,Micro,32,19,14,5,56,56,0
2023,1,Riyadh Region,Metal ore mining,Medium,2,66,30,36,94,94,0
2023,1,Qassim Region,Metal ore mining,Small,1,0,0,0,8,8,0
2023,1,Qassim Region,Metal ore mining,Micro,12,2,2,0,29,29,0
2023,1,Qassim Region,Metal ore mining,Medium,1,90,90,0,14,14,0
2023,1,Medina Region,Metal ore mining,Micro,7,1,1,0,15,15,0
2023,1,Tabuk Region,Metal ore mining,Small,1,0,0,0,6,6,0
2023,1,Jazan Region,Metal ore mining,Small,1,13,3,10,0,0,0
2023,1,Jazan Region,Metal ore mining,Micro,7,0,0,0,21,21,0
2023,1,Hail Region,Metal ore mining,Micro,2,0,0,0,5,5,0
2023,1,Asir Region,Metal ore mining,Small,4,5,2,3,29,29,0
2023,1,Asir Region,Metal ore mining,Micro,33,5,4,1,62,62,0
2023,1,Makkah Region,Metal ore mining,Small,6,26,8,18,79,77,2
2023,1,Makkah Region,Metal ore mining,Micro,39,13,7,6,72,72,0
2023,1,Makkah Region,Metal ore mining,Medium,4,414,384,30,52,52,0
2023,1,Najran Region,Metal ore mining,Small,1,0,0,0,13,13,0
2023,1,Najran Region,Metal ore mining,Micro,3,0,0,0,4,4,0
2023,1,Eastern Region,Coal and Lignite Mining,Small,2,5,5,0,13,13,0
2023,1,Eastern Region,Coal and Lignite Mining,Micro,5,3,3,0,8,8,0
2023,1,Riyadh Region,Coal and Lignite Mining,Small,2,3,2,1,18,18,0
2023,1,Riyadh Region,Coal and Lignite Mining,Micro,15,2,2,0,49,49,0
2023,1,Riyadh Region,Coal and Lignite Mining,Medium,2,69,30,39,63,63,0
2023,1,Qassim Region,Coal and Lignite Mining,Small,1,2,0,2,10,10,0
2023,1,Qassim Region,Coal and Lignite Mining,Micro,4,2,0,2,6,6,0
2023,1,Hail Region,Coal and Lignite Mining,Micro,1,0,0,0,4,4,0
2023,1,Makkah Region,Coal and Lignite Mining,Small,2,6,3,3,24,24,0
2023,1,Makkah Region,Coal and Lignite Mining,Micro,9,2,2,0,13,13,0
2023,1,Najran Region,Coal and Lignite Mining,Micro,1,0,0,0,4,4,0
2023,1,Eastern Region,Building construction,Small,5016,11316,5856,5460,67734,67530,204
2023,1,Eastern Region,Building construction,Large,139,25493,17518,7975,124966,124301,665
2023,1,Eastern Region,Building construction,Micro,12802,3061,1551,1510,30782,30671,111
2023,1,Eastern Region,Building construction,Medium,753,11023,6412,4611,64350,64223,127
2023,1,Al Bahah Region,Building construction,Small,216,354,240,114,2130,2122,8
2023,1,Al Bahah Region,Building construction,Micro,1283,223,123,100,3233,3225,8
2023,1,Al Bahah Region,Building construction,Medium,4,64,48,16,296,296,0
2023,1,Al-Jawf Region,Building construction,Small,243,332,207,125,2547,2540,7
2023,1,Al-Jawf Region,Building construction,Large,2,295,217,78,588,497,91
2023,1,Al-Jawf Region,Building construction,Micro,1638,211,134,77,4020,4012,8
2023,1,Al-Jawf Region,Building construction,Medium,7,102,66,36,466,466,0
2023,1,Northern border Region,Building construction,Small,176,275,160,115,1777,1771,6
2023,1,Northern border Region,Building construction,Large,3,380,223,157,2379,2355,24
2023,1,Northern border Region,Building construction,Micro,1609,146,79,67,4299,4291,8
2023,1,Northern border Region,Building construction,Medium,9,109,64,45,670,670,0
2023,1,Riyadh Region,Building construction,Small,7032,15183,6597,8586,89963,89293,670
2023,1,Riyadh Region,Building construction,Large,368,27021,14746,12275,227441,224833,2608
2023,1,Riyadh Region,Building construction,Micro,24451,5546,2590,2956,54430,53972,458
2023,1,Riyadh Region,Building construction,Medium,1129,14300,6877,7423,105577,104648,929
2023,1,Qassim Region,Building construction,Small,1329,1977,1167,810,15978,15873,105
2023,1,Qassim Region,Building construction,Large,32,476,288,188,13854,13773,81
2023,1,Qassim Region,Building construction,Micro,9515,1039,574,465,22829,22784,45
2023,1,Qassim Region,Building construction,Medium,156,1023,624,399,16680,16610,70
2023,1,Medina Region,Building construction,Small,1305,2354,1307,1047,14418,14347,71
2023,1,Medina Region,Building construction,Large,10,1531,645,886,13886,13416,470
2023,1,Medina Region,Building construction,Micro,6165,985,547,438,15520,15456,64
2023,1,Medina Region,Building construction,Medium,74,1055,600,455,5920,5910,10
2023,1,Tabuk Region,Building construction,Small,304,488,259,229,2952,2948,4
2023,1,Tabuk Region,Building construction,Large,1,47,47,0,240,240,0
2023,1,Tabuk Region,Building construction,Micro,2811,417,211,206,7224,7213,11
2023,1,Tabuk Region,Building construction,Medium,12,107,52,55,930,918,12
2023,1,Jazan Region,Building construction,Small,365,595,294,301,3591,3583,8
2023,1,Jazan Region,Building construction,Large,1,24,13,11,461,461,0
2023,1,Jazan Region,Building construction,Micro,4244,520,281,239,11008,10981,27
2023,1,Jazan Region,Building construction,Medium,12,212,119,93,1020,1007,13
2023,1,Hail Region,Building construction,Small,381,507,231,276,4035,4016,19
2023,1,Hail Region,Building construction,Large,3,18,6,12,1083,1083,0
2023,1,Hail Region,Building construction,Micro,3182,352,186,166,7669,7650,19
2023,1,Hail Region,Building construction,Medium,28,373,232,141,2352,2351,1
2023,1,Asir Region,Building construction,Small,981,1543,914,629,9636,9597,39
2023,1,Asir Region,Building construction,Large,3,307,292,15,1415,1415,0
2023,1,Asir Region,Building construction,Micro,8294,1156,656,500,19950,19918,32
2023,1,Asir Region,Building construction,Medium,39,646,438,208,2947,2941,6
2023,1,Makkah Region,Building construction,Small,5237,9499,4530,4969,60552,60037,515
2023,1,Makkah Region,Building construction,Large,92,13017,9148,3869,88813,88090,723
2023,1,Makkah Region,Building construction,Micro,22418,4296,2120,2176,55057,54559,498
2023,1,Makkah Region,Building construction,Medium,474,7235,4085,3150,39388,39055,333
2023,1,Najran Region,Building construction,Small,374,564,276,288,3989,3977,12
2023,1,Najran Region,Building construction,Large,8,938,479,459,2769,2761,8
2023,1,Najran Region,Building construction,Micro,2727,277,136,141,6447,6418,29
2023,1,Najran Region,Building construction,Medium,44,674,424,250,4270,4268,2
2023,1,Eastern Region,"Water collection, treatment and delivery",Small,35,162,113,49,407,407,0
2023,1,Eastern Region,"Water collection, treatment and delivery",Large,2,812,800,12,212,212,0
2023,1,Eastern Region,"Water collection, treatment and delivery",Micro,83,31,15,16,169,169,0
2023,1,Eastern Region,"Water collection, treatment and delivery",Medium,1,137,131,6,103,103,0
2023,1,Al Bahah Region,"Water collection, treatment and delivery",Small,2,2,1,1,13,13,0
2023,1,Al Bahah Region,"Water collection, treatment and delivery",Micro,30,5,3,2,56,56,0
2023,1,Al-Jawf Region,"Water collection, treatment and delivery",Small,2,9,6,3,35,35,0
2023,1,Al-Jawf Region,"Water collection, treatment and delivery",Micro,20,0,0,0,48,48,0
2023,1,Al-Jawf Region,"Water collection, treatment and delivery",Medium,1,19,13,6,49,49,0
2023,1,Northern border Region,"Water collection, treatment and delivery",Small,5,4,3,1,35,35,0
2023,1,Northern border Region,"Water collection, treatment and delivery",Micro,17,3,3,0,42,42,0
2023,1,Riyadh Region,"Water collection, treatment and delivery",Small,61,222,121,101,586,585,1
2023,1,Riyadh Region,"Water collection, treatment and delivery",Large,2,264,218,46,556,551,5
2023,1,Riyadh Region,"Water collection, treatment and delivery",Micro,212,57,29,28,472,469,3
2023,1,Riyadh Region,"Water collection, treatment and delivery",Medium,13,465,302,163,1024,1024,0
2023,1,Qassim Region,"Water collection, treatment and delivery",Small,11,28,17,11,95,95,0
2023,1,Qassim Region,"Water collection, treatment and delivery",Micro,62,10,6,4,140,140,0
2023,1,Qassim Region,"Water collection, treatment and delivery",Medium,2,138,108,30,222,222,0
2023,1,Medina Region,"Water collection, treatment and delivery",Small,10,30,22,8,94,94,0
2023,1,Medina Region,"Water collection, treatment and delivery",Large,1,730,730,0,183,183,0
2023,1,Medina Region,"Water collection, treatment and delivery",Micro,65,15,7,8,117,117,0
2023,1,Medina Region,"Water collection, treatment and delivery",Medium,1,28,16,12,64,64,0
2023,1,Tabuk Region,"Water collection, treatment and delivery",Small,5,20,16,4,82,82,0
2023,1,Tabuk Region,"Water collection, treatment and delivery",Micro,50,9,4,5,102,101,1
2023,1,Jazan Region,"Water collection, treatment and delivery",Small,6,57,53,4,38,38,0
2023,1,Jazan Region,"Water collection, treatment and delivery",Micro,85,20,11,9,164,164,0
2023,1,Jazan Region,"Water collection, treatment and delivery",Medium,1,54,52,2,26,26,0
2023,1,Hail Region,"Water collection, treatment and delivery",Small,1,13,11,2,31,31,0
2023,1,Hail Region,"Water collection, treatment and delivery",Micro,32,4,1,3,71,71,0
2023,1,Hail Region,"Water collection, treatment and delivery",Medium,2,28,22,6,112,112,0
2023,1,Asir Region,"Water collection, treatment and delivery",Small,16,55,28,27,187,187,0
2023,1,Asir Region,"Water collection, treatment and delivery",Micro,141,22,10,12,263,263,0
2023,1,Makkah Region,"Water collection, treatment and delivery",Small,66,314,232,82,583,582,1
2023,1,Makkah Region,"Water collection, treatment and delivery",Micro,385,74,37,37,831,828,3
2023,1,Makkah Region,"Water collection, treatment and delivery",Medium,11,672,598,74,540,539,1
2023,1,Najran Region,"Water collection, treatment and delivery",Small,6,6,4,2,70,70,0
2023,1,Najran Region,"Water collection, treatment and delivery",Large,1,81,62,19,198,195,3
2023,1,Najran Region,"Water collection, treatment and delivery",Micro,25,6,3,3,50,50,0
2023,1,Najran Region,"Water collection, treatment and delivery",Medium,1,21,17,4,35,35,0
2023,1,Eastern Region,"Wholesale and retail trade, repair of motor vehicles and motorcycles",Small,1929,4480,2940,1540,17542,17519,23
2023,1,Eastern Region,"Wholesale and retail trade, repair of motor vehicles and motorcycles",Large,7,1057,901,156,1535,1533,2
2023,1,Eastern Region,"Wholesale and retail trade, repair of motor vehicles and motorcycles",Micro,7246,1955,1321,634,16975,16953,22
2023,1,Eastern Region,"Wholesale and retail trade, repair of motor vehicles and motorcycles",Medium,64,1849,1435,414,3920,3919,1
2023,1,Al Bahah Region,"Wholesale and retail trade, repair of motor vehicles and motorcycles",Small,72,136,104,32,513,512,1
2023,1,Al Bahah Region,"Wholesale and retail trade, repair of motor vehicles and motorcycles",Micro,711,139,111,28,1580,1579,1
2023,1,Al-Jawf Region,"Wholesale and retail trade, repair of motor vehicles and motorcycles",Small,117,202,162,40,949,948,1
2023,1,Al-Jawf Region,"Wholesale and retail trade, repair of motor vehicles and motorcycles",Micro,1045,163,120,43,2463,2458,5
2023,1,Northern border Region,"Wholesale and retail trade, repair of motor vehicles and motorcycles",Small,72,141,85,56,570,567,3
2023,1,Northern border Region,"Wholesale and retail trade, repair of motor vehicles and motorcycles",Micro,726,107,84,23,1734,1733,1
2023,1,Riyadh Region,"Wholesale and retail trade, repair of motor vehicles and motorcycles",Small,2798,7414,3843,3571,27353,27260,93
2023,1,Riyadh Region,"Wholesale and retail trade, repair of motor vehicles and motorcycles",Large,9,1812,1580,232,4325,4320,5
2023,1,Riyadh Region,"Wholesale and retail trade, repair of motor vehicles and motorcycles",Micro,14216,2859,1630,1229,33390,33265,125
2023,1,Riyadh Region,"Wholesale and retail trade, repair of motor vehicles and motorcycles",Medium,121,2983,1928,1055,8147,8107,40
2023,1,Qassim Region,"Wholesale and retail trade, repair of motor vehicles and motorcycles",Small,518,1238,893,345,4709,4707,2
2023,1,Qassim Region,"Wholesale and retail trade, repair of motor vehicles and motorcycles",Large,1,0,0,0,251,251,0
2023,1,Qassim Region,"Wholesale and retail trade, repair of motor vehicles and motorcycles",Micro,3658,588,413,175,8445,8438,7
2023,1,Qassim Region,"Wholesale and retail trade, repair of motor vehicles and motorcycles",Medium,7,87,56,31,391,391,0
2023,1,Medina Region,"Wholesale and retail trade, repair of motor vehicles and motorcycles",Small,381,807,560,247,2986,2978,8
2023,1,Medina Region,"Wholesale and retail trade, repair of motor vehicles and motorcycles",Micro,3443,633,443,190,8078,8066,12
2023,1,Medina Region,"Wholesale and retail trade, repair of motor vehicles and motorcycles",Medium,3,61,44,17,250,250,0
2023,1,Tabuk Region,"Wholesale and retail trade, repair of motor vehicles and motorcycles",Small,181,366,276,90,1454,1452,2
2023,1,Tabuk Region,"Wholesale and retail trade, repair of motor vehicles and motorcycles",Micro,1744,263,178,85,4221,4215,6
2023,1,Tabuk Region,"Wholesale and retail trade, repair of motor vehicles and motorcycles",Medium,3,48,38,10,154,154,0
2023,1,Jazan Region,"Wholesale and retail trade, repair of motor vehicles and motorcycles",Small,163,375,278,97,1329,1326,3
2023,1,Jazan Region,"Wholesale and retail trade, repair of motor vehicles and motorcycles",Large,1,121,111,10,229,229,0
2023,1,Jazan Region,"Wholesale and retail trade, repair of motor vehicles and motorcycles",Micro,2756,353,248,105,6532,6523,9
2023,1,Jazan Region,"Wholesale and retail trade, repair of motor vehicles and motorcycles",Medium,4,76,61,15,232,231,1
2023,1,Hail Region,"Wholesale and retail trade, repair of motor vehicles and motorcycles",Small,213,450,292,158,1918,1917,1
2023,1,Hail Region,"Wholesale and retail trade, repair of motor vehicles and motorcycles",Micro,1394,209,138,71,3274,3270,4
2023,1,Hail Region,"Wholesale and retail trade, repair of motor vehicles and motorcycles",Medium,2,40,26,14,107,107,0
2023,1,Asir Region,"Wholesale and retail trade, repair of motor vehicles and motorcycles",Small,528,1175,801,374,4561,4559,2
2023,1,Asir Region,"Wholesale and retail trade, repair of motor vehicles and motorcycles",Micro,4187,704,500,204,9718,9694,24
2023,1,Asir Region,"Wholesale and retail trade, repair of motor vehicles and motorcycles",Medium,9,215,184,31,480,480,0
2023,1,Makkah Region,"Wholesale and retail trade, repair of motor vehicles and motorcycles",Small,1633,4245,2751,1494,14547,14491,56
2023,1,Makkah Region,"Wholesale and retail trade, repair of motor vehicles and motorcycles",Large,20,3970,3233,737,6688,6657,31
2023,1,Makkah Region,"Wholesale and retail trade, repair of motor vehicles and motorcycles",Micro,11488,2133,1349,784,27172,27040,132
2023,1,Makkah Region,"Wholesale and retail trade, repair of motor vehicles and motorcycles",Medium,77,2648,2121,527,4981,4963,18
2023,1,Najran Region,"Wholesale and retail trade, repair of motor vehicles and motorcycles",Small,97,222,133,89,937,936,1
2023,1,Najran Region,"Wholesale and retail trade, repair of motor vehicles and motorcycles",Micro,914,128,77,51,2220,2214,6
2023,1,Najran Region,"Wholesale and retail trade, repair of motor vehicles and motorcycles",Medium,3,53,25,28,130,129,1
2023,1,Eastern Region,"Wholesale trade, excluding motor vehicles and motorcycles",Small,2322,9336,5154,4182,21830,21745,85
2023,1,Eastern Region,"Wholesale trade, excluding motor vehicles and motorcycles",Large,14,3854,2428,1426,3977,3967,10
2023,1,Eastern Region,"Wholesale trade, excluding motor vehicles and motorcycles",Micro,6642,3557,1969,1588,12805,12721,84
2023,1,Eastern Region,"Wholesale trade, excluding motor vehicles and motorcycles",Medium,184,6688,4308,2380,11719,11625,94
2023,1,Al Bahah Region,"Wholesale trade, excluding motor vehicles and motorcycles",Small,87,273,179,94,733,732,1
2023,1,Al Bahah Region,"Wholesale trade, excluding motor vehicles and motorcycles",Micro,422,167,118,49,810,805,5
2023,1,Al Bahah Region,"Wholesale trade, excluding motor vehicles and motorcycles",Medium,2,48,33,15,88,88,0
2023,1,Al-Jawf Region,"Wholesale trade, excluding motor vehicles and motorcycles",Small,117,325,209,116,998,996,2
2023,1,Al-Jawf Region,"Wholesale trade, excluding motor vehicles and motorcycles",Micro,643,195,131,64,1305,1300,5
2023,1,Al-Jawf Region,"Wholesale trade, excluding motor vehicles and motorcycles",Medium,2,99,31,68,162,161,1
2023,1,Northern border Region,"Wholesale trade, excluding motor vehicles and motorcycles",Small,48,123,70,53,357,356,1
2023,1,Northern border Region,"Wholesale trade, excluding motor vehicles and motorcycles",Micro,407,111,67,44,879,878,1
2023,1,Northern border Region,"Wholesale trade, excluding motor vehicles and motorcycles",Medium,1,0,0,0,108,108,0
2023,1,Riyadh Region,"Wholesale trade, excluding motor vehicles and motorcycles",Small,5411,22267,9981,12286,53693,53022,671
2023,1,Riyadh Region,"Wholesale trade, excluding motor vehicles and motorcycles",Large,57,19601,11956,7645,19388,19003,385
2023,1,Riyadh Region,"Wholesale trade, excluding motor vehicles and motorcycles",Micro,17008,6863,3249,3614,33868,33360,508
2023,1,Riyadh Region,"Wholesale trade, excluding motor vehicles and motorcycles",Medium,430,14732,7455,7277,25885,25482,403
2023,1,Qassim Region,"Wholesale trade, excluding motor vehicles and motorcycles",Small,435,1552,935,617,3988,3970,18
2023,1,Qassim Region,"Wholesale trade, excluding motor vehicles and motorcycles",Large,1,290,82,208,7,7,0
2023,1,Qassim Region,"Wholesale trade, excluding motor vehicles and motorcycles",Micro,2238,759,500,259,4519,4493,26
2023,1,Qassim Region,"Wholesale trade, excluding motor vehicles and motorcycles",Medium,25,419,281,138,1597,1579,18
2023,1,Medina Region,"Wholesale trade, excluding motor vehicles and motorcycles",Small,644,2215,1335,880,5323,5285,38
2023,1,Medina Region,"Wholesale trade, excluding motor vehicles and motorcycles",Micro,3105,990,591,399,6409,6351,58
2023,1,Medina Region,"Wholesale trade, excluding motor vehicles and motorcycles",Medium,18,525,337,188,1051,1048,3
2023,1,Tabuk Region,"Wholesale trade, excluding motor vehicles and motorcycles",Small,159,614,323,291,1514,1511,3
2023,1,Tabuk Region,"Wholesale trade, excluding motor vehicles and motorcycles",Micro,936,322,169,153,1824,1815,9
2023,1,Tabuk Region,"Wholesale trade, excluding motor vehicles and motorcycles",Medium,9,190,121,69,510,508,2
2023,1,Jazan Region,"Wholesale trade, excluding motor vehicles and motorcycles",Small,253,843,473,370,2369,2366,3
2023,1,Jazan Region,"Wholesale trade, excluding motor vehicles and motorcycles",Micro,1803,425,259,166,3904,3882,22
2023,1,Jazan Region,"Wholesale trade, excluding motor vehicles and motorcycles",Medium,5,86,63,23,352,350,2
2023,1,Hail Region,"Wholesale trade, excluding motor vehicles and motorcycles",Small,160,553,279,274,1413,1404,9
2023,1,Hail Region,"Wholesale trade, excluding motor vehicles and motorcycles",Micro,760,219,134,85,1624,1618,6
2023,1,Hail Region,"Wholesale trade, excluding motor vehicles and motorcycles",Medium,4,79,62,17,185,185,0
2023,1,Asir Region,"Wholesale trade, excluding motor vehicles and motorcycles",Small,527,1898,1220,678,4713,4707,6
2023,1,Asir Region,"Wholesale trade, excluding motor vehicles and motorcycles",Micro,2279,863,553,310,4794,4768,26
2023,1,Asir Region,"Wholesale trade, excluding motor vehicles and motorcycles",Medium,18,516,321,195,952,946,6
2023,1,Makkah Region,"Wholesale trade, excluding motor vehicles and motorcycles",Small,4868,18902,8933,9969,47978,47330,648
2023,1,Makkah Region,"Wholesale trade, excluding motor vehicles and motorcycles",Large,36,7361,5245,2116,9129,8946,183
2023,1,Makkah Region,"Wholesale trade, excluding motor vehicles and motorcycles",Micro,15126,5562,2756,2806,31487,30903,584
2023,1,Makkah Region,"Wholesale trade, excluding motor vehicles and motorcycles",Medium,358,12727,6879,5848,21257,20943,314
2023,1,Najran Region,"Wholesale trade, excluding motor vehicles and motorcycles",Small,106,345,189,156,979,966,13
2023,1,Najran Region,"Wholesale trade, excluding motor vehicles and motorcycles",Micro,627,164,92,72,1432,1424,8
2023,1,Najran Region,"Wholesale trade, excluding motor vehicles and motorcycles",Medium,6,152,91,61,286,286,0
2023,1,Eastern Region,"Retail trade, excluding motor vehicles and motorcycles",Small,3503,12795,6108,6687,30546,30333,213
2023,1,Eastern Region,"Retail trade, excluding motor vehicles and motorcycles",Large,28,7321,3802,3519,10785,10028,757
2023,1,Eastern Region,"Retail trade, excluding motor vehicles and motorcycles",Micro,17541,7471,3790,3681,34790,34568,222
2023,1,Eastern Region,"Retail trade, excluding motor vehicles and motorcycles",Medium,206,6991,3526,3465,13068,12993,75
2023,1,Al Bahah Region,"Retail trade, excluding motor vehicles and motorcycles",Small,239,750,478,272,1781,1779,2
2023,1,Al Bahah Region,"Retail trade, excluding motor vehicles and motorcycles",Micro,1601,596,377,219,2938,2925,13
2023,1,Al Bahah Region,"Retail trade, excluding motor vehicles and motorcycles",Medium,4,72,54,18,171,171,0
2023,1,Al-Jawf Region,"Retail trade, excluding motor vehicles and motorcycles",Small,301,805,480,325,2367,2341,26
2023,1,Al-Jawf Region,"Retail trade, excluding motor vehicles and motorcycles",Micro,2591,714,454,260,5120,5100,20
2023,1,Al-Jawf Region,"Retail trade, excluding motor vehicles and motorcycles",Medium,6,178,66,112,348,348,0
2023,1,Northern border Region,"Retail trade, excluding motor vehicles and motorcycles",Small,168,463,225,238,1322,1312,10
2023,1,Northern border Region,"Retail trade, excluding motor vehicles and motorcycles",Micro,1952,462,249,213,4035,4016,19
2023,1,Northern border Region,"Retail trade, excluding motor vehicles and motorcycles",Medium,4,63,43,20,301,293,8
2023,1,Riyadh Region,"Retail trade, excluding motor vehicles and motorcycles",Small,7120,28831,12161,16670,69736,68715,1021
2023,1,Riyadh Region,"Retail trade, excluding motor vehicles and motorcycles",Large,100,34209,18792,15417,47682,47059,623
2023,1,Riyadh Region,"Retail trade, excluding motor vehicles and motorcycles",Micro,33690,11379,5417,5962,70093,69126,967
2023,1,Riyadh Region,"Retail trade, excluding motor vehicles and motorcycles",Medium,603,19870,8906,10964,37666,36920,746
2023,1,Qassim Region,"Retail trade, excluding motor vehicles and motorcycles",Small,1069,3747,2356,1391,9530,9485,45
2023,1,Qassim Region,"Retail trade, excluding motor vehicles and motorcycles",Large,3,434,147,287,992,992,0
2023,1,Qassim Region,"Retail trade, excluding motor vehicles and motorcycles",Micro,6874,2239,1368,871,13818,13745,73
2023,1,Qassim Region,"Retail trade, excluding motor vehicles and motorcycles",Medium,58,1354,793,561,3359,3355,4
2023,1,Medina Region,"Retail trade, excluding motor vehicles and motorcycles",Small,1361,4678,2537,2141,10691,10625,66
2023,1,Medina Region,"Retail trade, excluding motor vehicles and motorcycles",Large,1,89,50,39,233,233,0
2023,1,Medina Region,"Retail trade, excluding motor vehicles and motorcycles",Micro,10349,3160,1917,1243,21572,21357,215
2023,1,Medina Region,"Retail trade, excluding motor vehicles and motorcycles",Medium,54,1627,706,921,3005,2970,35
2023,1,Tabuk Region,"Retail trade, excluding motor vehicles and motorcycles",Small,423,1332,662,670,3106,3092,14
2023,1,Tabuk Region,"Retail trade, excluding motor vehicles and motorcycles",Large,1,162,128,34,231,231,0
2023,1,Tabuk Region,"Retail trade, excluding motor vehicles and motorcycles",Micro,3972,1124,597,527,7966,7929,37
2023,1,Tabuk Region,"Retail trade, excluding motor vehicles and motorcycles",Medium,7,370,134,236,448,448,0
2023,1,Jazan Region,"Retail trade, excluding motor vehicles and motorcycles",Small,738,2217,1172,1045,6027,6005,22
2023,1,Jazan Region,"Retail trade, excluding motor vehicles and motorcycles",Micro,7362,1935,1100,835,15228,15122,106
2023,1,Jazan Region,"Retail trade, excluding motor vehicles and motorcycles",Medium,16,728,277,451,885,873,12
2023,1,Hail Region,"Retail trade, excluding motor vehicles and motorcycles",Small,403,1236,609,627,3415,3386,29
2023,1,Hail Region,"Retail trade, excluding motor vehicles and motorcycles",Large,1,170,76,94,267,267,0
2023,1,Hail Region,"Retail trade, excluding motor vehicles and motorcycles",Micro,3449,1004,507,497,6975,6937,38
2023,1,Hail Region,"Retail trade, excluding motor vehicles and motorcycles",Medium,13,305,101,204,604,603,1
2023,1,Asir Region,"Retail trade, excluding motor vehicles and motorcycles",Small,1213,4091,2186,1905,9738,9704,34
2023,1,Asir Region,"Retail trade, excluding motor vehicles and motorcycles",Large,2,408,182,226,447,444,3
2023,1,Asir Region,"Retail trade, excluding motor vehicles and motorcycles",Micro,9539,3128,1976,1152,18797,18703,94
2023,1,Asir Region,"Retail trade, excluding motor vehicles and motorcycles",Medium,32,865,376,489,1746,1707,39
2023,1,Makkah Region,"Retail trade, excluding motor vehicles and motorcycles",Small,6140,23510,10406,13104,54797,54023,774
2023,1,Makkah Region,"Retail trade, excluding motor vehicles and motorcycles",Large,40,11187,5212,5975,12398,12004,394
2023,1,Makkah Region,"Retail trade, excluding motor vehicles and motorcycles",Micro,34011,10938,5658,5280,71725,70587,1138
2023,1,Makkah Region,"Retail trade, excluding motor vehicles and motorcycles",Medium,394,13461,6748,6713,23575,23181,394
2023,1,Najran Region,"Retail trade, excluding motor vehicles and motorcycles",Small,308,859,398,461,2601,2579,22
2023,1,Najran Region,"Retail trade, excluding motor vehicles and motorcycles",Micro,2678,552,277,275,5683,5648,35
2023,1,Najran Region,"Retail trade, excluding motor vehicles and motorcycles",Medium,9,299,97,202,633,627,6
2023,1,Eastern Region,"Crop cultivation, livestock production, fishing and related services activities",Small,265,365,193,172,3031,3026,5
2023,1,Eastern Region,"Crop cultivation, livestock production, fishing and related services activities",Large,3,1840,1288,552,9667,9648,19
2023,1,Eastern Region,"Crop cultivation, livestock production, fishing and related services activities",Micro,1881,261,139,122,2816,2812,4
2023,1,Eastern Region,"Crop cultivation, livestock production, fishing and related services activities",Medium,23,390,256,134,1908,1903,5
2023,1,Al Bahah Region,"Crop cultivation, livestock production, fishing and related services activities",Small,7,8,8,0,43,43,0
2023,1,Al Bahah Region,"Crop cultivation, livestock production, fishing and related services activities",Micro,164,12,8,4,201,201,0
2023,1,Al-Jawf Region,"Crop cultivation, livestock production, fishing and related services activities",Small,21,46,25,21,196,196,0
2023,1,Al-Jawf Region,"Crop cultivation, livestock production, fishing and related services activities",Large,1,118,108,10,799,796,3
2023,1,Al-Jawf Region,"Crop cultivation, livestock production, fishing and related services activities",Micro,809,42,25,17,1158,1152,6
2023,1,Al-Jawf Region,"Crop cultivation, livestock production, fishing and related services activities",Medium,1,1,1,0,63,63,0
2023,1,Northern border Region,"Crop cultivation, livestock production, fishing and related services activities",Small,2,1,1,0,15,15,0
2023,1,Northern border Region,"Crop cultivation, livestock production, fishing and related services activities",Micro,86,8,4,4,101,101,0
2023,1,Riyadh Region,"Crop cultivation, livestock production, fishing and related services activities",Small,485,907,399,508,6562,6516,46
2023,1,Riyadh Region,"Crop cultivation, livestock production, fishing and related services activities",Large,19,2096,1781,315,16388,16373,15
2023,1,Riyadh Region,"Crop cultivation, livestock production, fishing and related services activities",Micro,7311,598,276,322,12973,12913,60
2023,1,Riyadh Region,"Crop cultivation, livestock production, fishing and related services activities",Medium,90,983,428,555,8211,8161,50
2023,1,Qassim Region,"Crop cultivation, livestock production, fishing and related services activities",Small,93,171,94,77,1258,1253,5
2023,1,Qassim Region,"Crop cultivation, livestock production, fishing and related services activities",Large,3,1491,1114,377,6001,6000,1
2023,1,Qassim Region,"Crop cultivation, livestock production, fishing and related services activities",Micro,1274,146,96,50,1884,1876,8
2023,1,Qassim Region,"Crop cultivation, livestock production, fishing and related services activities",Medium,15,207,144,63,1481,1479,2
2023,1,Medina Region,"Crop cultivation, livestock production, fishing and related services activities",Small,48,82,50,32,546,543,3
2023,1,Medina Region,"Crop cultivation, livestock production, fishing and related services activities",Micro,885,92,63,29,1248,1240,8
2023,1,Medina Region,"Crop cultivation, livestock production, fishing and related services activities",Medium,4,59,36,23,340,340,0
2023,1,Tabuk Region,"Crop cultivation, livestock production, fishing and related services activities",Small,34,27,14,13,472,472,0
2023,1,Tabuk Region,"Crop cultivation, livestock production, fishing and related services activities",Large,2,216,133,83,1189,1188,1
2023,1,Tabuk Region,"Crop cultivation, livestock production, fishing and related services activities",Micro,857,50,29,21,1091,1091,0
2023,1,Tabuk Region,"Crop cultivation, livestock production, fishing and related services activities",Medium,2,0,0,0,121,121,0
2023,1,Jazan Region,"Crop cultivation, livestock production, fishing and related services activities",Small,32,37,22,15,351,349,2
2023,1,Jazan Region,"Crop cultivation, livestock production, fishing and related services activities",Micro,766,27,21,6,1279,1275,4
2023,1,Jazan Region,"Crop cultivation, livestock production, fishing and related services activities",Medium,1,5,4,1,50,50,0
2023,1,Hail Region,"Crop cultivation, livestock production, fishing and related services activities",Small,45,39,24,15,497,494,3
2023,1,Hail Region,"Crop cultivation, livestock production, fishing and related services activities",Large,2,675,662,13,2076,2075,1
2023,1,Hail Region,"Crop cultivation, livestock production, fishing and related services activities",Micro,1495,69,37,32,2696,2690,6
2023,1,Hail Region,"Crop cultivation, livestock production, fishing and related services activities",Medium,6,43,26,17,539,539,0
2023,1,Asir Region,"Crop cultivation, livestock production, fishing and related services activities",Small,62,78,52,26,698,696,2
2023,1,Asir Region,"Crop cultivation, livestock production, fishing and related services activities",Micro,1139,64,39,25,1433,1431,2
2023,1,Asir Region,"Crop cultivation, livestock production, fishing and related services activities",Medium,6,51,34,17,555,555,0
2023,1,Makkah Region,"Crop cultivation, livestock production, fishing and related services activities",Small,107,147,74,73,1126,1114,12
2023,1,Makkah Region,"Crop cultivation, livestock production, fishing and related services activities",Large,3,492,285,207,2683,2682,1
2023,1,Makkah Region,"Crop cultivation, livestock production, fishing and related services activities",Micro,2098,134,66,68,3095,3085,10
2023,1,Makkah Region,"Crop cultivation, livestock production, fishing and related services activities",Medium,9,85,38,47,733,646,87
2023,1,Najran Region,"Crop cultivation, livestock production, fishing and related services activities",Small,19,18,9,9,217,217,0
2023,1,Najran Region,"Crop cultivation, livestock production, fishing and related services activities",Micro,703,18,8,10,1035,1029,6
2023,1,Najran Region,"Crop cultivation, livestock production, fishing and related services activities",Medium,2,8,7,1,194,194,0
2023,1,Eastern Region,Mining support services activities,Small,57,481,391,90,633,625,8
2023,1,Eastern Region,Mining support services activities,Large,27,28346,27222,1124,11464,11444,20
2023,1,Eastern Region,Mining support services activities,Micro,77,93,66,27,93,92,1
2023,1,Eastern Region,Mining support services activities,Medium,23,1405,1294,111,1070,1064,6
2023,1,Al Bahah Region,Mining support services activities,Micro,3,0,0,0,6,6,0
2023,1,Al-Jawf Region,Mining support services activities,Micro,6,0,0,0,12,12,0
2023,1,Northern border Region,Mining support services activities,Small,2,5,3,2,24,24,0
2023,1,Riyadh Region,Mining support services activities,Small,11,73,46,27,150,150,0
2023,1,Riyadh Region,Mining support services activities,Large,1,538,426,112,127,127,0
2023,1,Riyadh Region,Mining support services activities,Micro,46,68,48,20,35,35,0
2023,1,Riyadh Region,Mining support services activities,Medium,2,87,74,13,158,156,2
2023,1,Qassim Region,Mining support services activities,Micro,4,2,1,1,13,13,0
2023,1,Medina Region,Mining support services activities,Micro,4,1,1,0,4,4,0
2023,1,Tabuk Region,Mining support services activities,Small,1,3,2,1,13,13,0
2023,1,Tabuk Region,Mining support services activities,Micro,1,0,0,0,1,1,0
2023,1,Jazan Region,Mining support services activities,Small,1,0,0,0,22,22,0
2023,1,Jazan Region,Mining support services activities,Micro,3,0,0,0,8,8,0
2023,1,Hail Region,Mining support services activities,Micro,4,0,0,0,8,8,0
2023,1,Asir Region,Mining support services activities,Micro,14,2,1,1,28,28,0
2023,1,Makkah Region,Mining support services activities,Small,9,38,26,12,68,65,3
2023,1,Makkah Region,Mining support services activities,Large,2,294,160,134,625,624,1
2023,1,Makkah Region,Mining support services activities,Micro,31,13,10,3,49,49,0
2023,1,Makkah Region,Mining support services activities,Medium,3,289,248,41,177,175,2
2023,1,Najran Region,Mining support services activities,Micro,1,1,1,0,0,0,0
2023,1,Eastern Region,Information services activities,Small,21,118,66,52,142,139,3
2023,1,Eastern Region,Information services activities,Micro,40,36,17,19,48,47,1
2023,1,Eastern Region,Information services activities,Medium,6,589,312,277,146,142,4
2023,1,Al-Jawf Region,Information services activities,Small,1,0,0,0,7,7,0
2023,1,Al-Jawf Region,Information services activities,Micro,4,1,0,1,6,6,0
2023,1,Northern border Region,Information services activities,Micro,1,0,0,0,1,1,0
2023,1,Riyadh Region,Information services activities,Small,157,1217,614,603,1449,1383,66
2023,1,Riyadh Region,Information services activities,Large,7,6360,3366,2994,2781,2697,84
2023,1,Riyadh Region,Information services activities,Micro,252,236,130,106,343,326,17
2023,1,Riyadh Region,Information services activities,Medium,41,2530,1461,1069,2064,1977,87
2023,1,Qassim Region,Information services activities,Small,2,4,2,2,22,22,0
2023,1,Qassim Region,Information services activities,Micro,8,5,3,2,11,11,0
2023,1,Medina Region,Information services activities,Small,2,3,0,3,10,10,0
2023,1,Medina Region,Information services activities,Micro,17,11,5,6,22,21,1
2023,1,Medina Region,Information services activities,Medium,1,54,19,35,7,6,1
2023,1,Tabuk Region,Information services activities,Small,1,2,1,1,4,4,0
2023,1,Tabuk Region,Information services activities,Micro,8,4,1,3,9,9,0
2023,1,Jazan Region,Information services activities,Micro,4,1,0,1,9,9,0
2023,1,Hail Region,Information services activities,Small,1,4,1,3,5,5,0
2023,1,Hail Region,Information services activities,Micro,3,0,0,0,10,10,0
2023,1,Asir Region,Information services activities,Small,1,3,0,3,3,2,1
2023,1,Asir Region,Information services activities,Micro,7,2,1,1,9,9,0
2023,1,Makkah Region,Information services activities,Small,48,329,139,190,420,406,14
2023,1,Makkah Region,Information services activities,Micro,124,75,34,41,192,182,10
2023,1,Makkah Region,Information services activities,Medium,4,255,97,158,189,166,23
2023,1,Najran Region,Information services activities,Micro,1,0,0,0,1,1,0
2023,1,Eastern Region,Food and beverage service activities,Small,3851,10713,4922,5791,39242,39070,172
2023,1,Eastern Region,Food and beverage service activities,Large,18,2904,1973,931,6468,6391,77
2023,1,Eastern Region,Food and beverage service activities,Micro,9411,3225,1454,1771,21273,21165,108
2023,1,Eastern Region,Food and beverage service activities,Medium,208,4683,1864,2819,13887,13831,56
2023,1,Al Bahah Region,Food and beverage service activities,Small,228,510,345,165,2068,2055,13
2023,1,Al Bahah Region,Food and beverage service activities,Micro,893,271,179,92,1959,1950,9
2023,1,Al Bahah Region,Food and beverage service activities,Medium,2,72,47,25,193,192,1
2023,1,Al-Jawf Region,Food and beverage service activities,Small,222,516,331,185,2166,2163,3
2023,1,Al-Jawf Region,Food and beverage service activities,Micro,1173,228,129,99,2648,2633,15
2023,1,Al-Jawf Region,Food and beverage service activities,Medium,5,93,59,34,239,237,2
2023,1,Northern border Region,Food and beverage service activities,Small,149,328,182,146,1575,1569,6
2023,1,Northern border Region,Food and beverage service activities,Micro,1158,188,99,89,2873,2859,14
2023,1,Northern border Region,Food and beverage service activities,Medium,4,58,19,39,272,265,7
2023,1,Riyadh Region,Food and beverage service activities,Small,4783,15050,6001,9049,54729,54095,634
2023,1,Riyadh Region,Food and beverage service activities,Large,68,18671,11924,6747,40741,39914,827
2023,1,Riyadh Region,Food and beverage service activities,Micro,13735,3999,1758,2241,30721,30420,301
2023,1,Riyadh Region,Food and beverage service activities,Medium,482,11127,4462,6665,33197,32763,434
2023,1,Qassim Region,Food and beverage service activities,Small,888,2184,1367,817,8945,8926,19
2023,1,Qassim Region,Food and beverage service activities,Large,1,64,47,17,187,187,0
2023,1,Qassim Region,Food and beverage service activities,Micro,4323,811,491,320,10796,10767,29
2023,1,Qassim Region,Food and beverage service activities,Medium,34,652,353,299,1977,1976,1
2023,1,Medina Region,Food and beverage service activities,Small,1242,3111,1664,1447,11777,11722,55
2023,1,Medina Region,Food and beverage service activities,Large,2,200,162,38,523,521,2
2023,1,Medina Region,Food and beverage service activities,Micro,5614,1337,735,602,12630,12532,98
2023,1,Medina Region,Food and beverage service activities,Medium,33,654,406,248,1794,1788,6
2023,1,Tabuk Region,Food and beverage service activities,Small,451,1140,512,628,4590,4566,24
2023,1,Tabuk Region,Food and beverage service activities,Large,2,177,57,120,485,444,41
2023,1,Tabuk Region,Food and beverage service activities,Micro,2472,472,223,249,5715,5688,27
2023,1,Tabuk Region,Food and beverage service activities,Medium,11,233,116,117,752,751,1
2023,1,Jazan Region,Food and beverage service activities,Small,677,1675,863,812,6323,6308,15
2023,1,Jazan Region,Food and beverage service activities,Micro,4697,877,464,413,10465,10418,47
2023,1,Jazan Region,Food and beverage service activities,Medium,15,209,111,98,772,772,0
2023,1,Hail Region,Food and beverage service activities,Small,326,695,368,327,3147,3122,25
2023,1,Hail Region,Food and beverage service activities,Large,2,163,64,99,502,496,6
2023,1,Hail Region,Food and beverage service activities,Micro,1950,327,182,145,4587,4565,22
2023,1,Hail Region,Food and beverage service activities,Medium,13,189,104,85,830,827,3
2023,1,Asir Region,Food and beverage service activities,Small,1313,3342,1819,1523,12971,12949,22
2023,1,Asir Region,Food and beverage service activities,Micro,6388,1448,758,690,14701,14624,77
2023,1,Asir Region,Food and beverage service activities,Medium,48,894,466,428,2591,2574,17
2023,1,Makkah Region,Food and beverage service activities,Small,4536,13076,5942,7134,48590,48016,574
2023,1,Makkah Region,Food and beverage service activities,Large,24,6115,4156,1959,13968,13746,222
2023,1,Makkah Region,Food and beverage service activities,Micro,17409,4476,2079,2397,38392,37857,535
2023,1,Makkah Region,Food and beverage service activities,Medium,301,6654,3174,3480,19158,18876,282
2023,1,Najran Region,Food and beverage service activities,Small,217,479,192,287,2330,2318,12
2023,1,Najran Region,Food and beverage service activities,Large,1,131,65,66,384,382,2
2023,1,Najran Region,Food and beverage service activities,Micro,1623,261,84,177,3806,3784,22
2023,1,Najran Region,Food and beverage service activities,Medium,8,171,63,108,598,595,3
2023,1,Eastern Region,"Waste collection, treatment, disposal, and material recovery activities",Small,50,166,88,78,622,620,2
2023,1,Eastern Region,"Waste collection, treatment, disposal, and material recovery activities",Large,3,1494,886,608,5544,4260,1284
2023,1,Eastern Region,"Waste collection, treatment, disposal, and material recovery activities",Micro,50,31,20,11,96,96,0
2023,1,Eastern Region,"Waste collection, treatment, disposal, and material recovery activities",Medium,16,353,234,119,1344,1342,2
2023,1,Al Bahah Region,"Waste collection, treatment, disposal, and material recovery activities",Micro,1,0,0,0,2,2,0
2023,1,Al-Jawf Region,"Waste collection, treatment, disposal, and material recovery activities",Small,1,2,0,2,13,13,0
2023,1,Al-Jawf Region,"Waste collection, treatment, disposal, and material recovery activities",Micro,3,2,2,0,2,2,0
2023,1,Riyadh Region,"Waste collection, treatment, disposal, and material recovery activities",Small,53,192,89,103,834,827,7
2023,1,Riyadh Region,"Waste collection, treatment, disposal, and material recovery activities",Large,12,5553,3554,1999,39461,37815,1646
2023,1,Riyadh Region,"Waste collection, treatment, disposal, and material recovery activities",Micro,124,40,20,20,274,271,3
2023,1,Riyadh Region,"Waste collection, treatment, disposal, and material recovery activities",Medium,14,267,183,84,1480,1480,0
2023,1,Qassim Region,"Waste collection, treatment, disposal, and material recovery activities",Small,10,37,20,17,127,127,0
2023,1,Qassim Region,"Waste collection, treatment, disposal, and material recovery activities",Micro,14,4,1,3,30,30,0
2023,1,Qassim Region,"Waste collection, treatment, disposal, and material recovery activities",Medium,2,25,16,9,160,111,49
2023,1,Medina Region,"Waste collection, treatment, disposal, and material recovery activities",Small,5,12,9,3,84,83,1
2023,1,Medina Region,"Waste collection, treatment, disposal, and material recovery activities",Large,2,428,279,149,1247,1152,95
2023,1,Medina Region,"Waste collection, treatment, disposal, and material recovery activities",Micro,12,8,2,6,22,22,0
2023,1,Medina Region,"Waste collection, treatment, disposal, and material recovery activities",Medium,3,48,31,17,206,206,0
2023,1,Tabuk Region,"Waste collection, treatment, disposal, and material recovery activities",Micro,5,3,2,1,11,11,0
2023,1,Jazan Region,"Waste collection, treatment, disposal, and material recovery activities",Small,6,14,10,4,77,77,0
2023,1,Jazan Region,"Waste collection, treatment, disposal, and material recovery activities",Micro,5,1,0,1,9,9,0
2023,1,Jazan Region,"Waste collection, treatment, disposal, and material recovery activities",Medium,1,16,5,11,62,62,0
2023,1,Hail Region,"Waste collection, treatment, disposal, and material recovery activities",Small,1,1,0,1,5,5,0
2023,1,Hail Region,"Waste collection, treatment, disposal, and material recovery activities",Micro,8,3,2,1,18,18,0
2023,1,Asir Region,"Waste collection, treatment, disposal, and material recovery activities",Small,3,6,2,4,41,41,0
2023,1,Asir Region,"Waste collection, treatment, disposal, and material recovery activities",Large,1,37,29,8,296,296,0
2023,1,Asir Region,"Waste collection, treatment, disposal, and material recovery activities",Micro,19,6,3,3,29,29,0
2023,1,Asir Region,"Waste collection, treatment, disposal, and material recovery activities",Medium,2,132,70,62,156,156,0
2023,1,Makkah Region,"Waste collection, treatment, disposal, and material recovery activities",Small,56,150,69,81,746,739,7
2023,1,Makkah Region,"Waste collection, treatment, disposal, and material recovery activities",Large,5,2053,1189,864,5926,5867,59
2023,1,Makkah Region,"Waste collection, treatment, disposal, and material recovery activities",Micro,93,50,26,24,193,191,2
2023,1,Makkah Region,"Waste collection, treatment, disposal, and material recovery activities",Medium,5,71,49,22,315,313,2
2023,1,Najran Region,"Waste collection, treatment, disposal, and material recovery activities",Small,1,2,0,2,13,13,0
2023,1,Najran Region,"Waste collection, treatment, disposal, and material recovery activities",Micro,12,2,0,2,32,32,0
2023,1,Eastern Region,Activities providing services to buildings and beautifying sites,Small,508,1461,746,715,6624,6524,100
2023,1,Eastern Region,Activities providing services to buildings and beautifying sites,Large,75,15564,10848,4716,69392,67949,1443
2023,1,Eastern Region,Activities providing services to buildings and beautifying sites,Micro,1187,386,208,178,2491,2472,19
2023,1,Eastern Region,Activities providing services to buildings and beautifying sites,Medium,146,3082,2062,1020,13606,13213,393
2023,1,Al Bahah Region,Activities providing services to buildings and beautifying sites,Small,7,19,13,6,65,65,0
2023,1,Al Bahah Region,Activities providing services to buildings and beautifying sites,Large,2,106,46,60,826,773,53
2023,1,Al Bahah Region,Activities providing services to buildings and beautifying sites,Micro,46,8,4,4,99,99,0
2023,1,Al Bahah Region,Activities providing services to buildings and beautifying sites,Medium,2,46,30,16,110,109,1
2023,1,Al-Jawf Region,Activities providing services to buildings and beautifying sites,Small,24,52,31,21,244,241,3
2023,1,Al-Jawf Region,Activities providing services to buildings and beautifying sites,Large,1,91,40,51,277,277,0
2023,1,Al-Jawf Region,Activities providing services to buildings and beautifying sites,Micro,186,24,11,13,421,412,9
2023,1,Al-Jawf Region,Activities providing services to buildings and beautifying sites,Medium,5,110,35,75,194,194,0
2023,1,Northern border Region,Activities providing services to buildings and beautifying sites,Small,9,40,19,21,103,103,0
2023,1,Northern border Region,Activities providing services to buildings and beautifying sites,Large,1,292,164,128,817,535,282
2023,1,Northern border Region,Activities providing services to buildings and beautifying sites,Micro,77,10,5,5,195,194,1
2023,1,Northern border Region,Activities providing services to buildings and beautifying sites,Medium,2,57,43,14,134,134,0
2023,1,Riyadh Region,Activities providing services to buildings and beautifying sites,Small,1351,4154,1931,2223,18747,18353,394
2023,1,Riyadh Region,Activities providing services to buildings and beautifying sites,Large,197,37757,21880,15877,158206,146547,11659
2023,1,Riyadh Region,Activities providing services to buildings and beautifying sites,Micro,3484,1019,494,525,7368,7255,113
2023,1,Riyadh Region,Activities providing services to buildings and beautifying sites,Medium,476,9020,4477,4543,44093,42452,1641
2023,1,Qassim Region,Activities providing services to buildings and beautifying sites,Small,194,485,283,202,2821,2791,30
2023,1,Qassim Region,Activities providing services to buildings and beautifying sites,Large,41,1710,753,957,17252,16939,313
2023,1,Qassim Region,Activities providing services to buildings and beautifying sites,Micro,1052,151,88,63,2615,2597,18
2023,1,Qassim Region,Activities providing services to buildings and beautifying sites,Medium,133,1581,881,700,14170,14015,155
2023,1,Medina Region,Activities providing services to buildings and beautifying sites,Small,146,396,231,165,1792,1752,40
2023,1,Medina Region,Activities providing services to buildings and beautifying sites,Large,4,262,79,183,1298,1250,48
2023,1,Medina Region,Activities providing services to buildings and beautifying sites,Micro,687,148,87,61,1601,1579,22
2023,1,Medina Region,Activities providing services to buildings and beautifying sites,Medium,35,820,525,295,3270,3160,110
2023,1,Tabuk Region,Activities providing services to buildings and beautifying sites,Small,34,83,47,36,348,348,0
2023,1,Tabuk Region,Activities providing services to buildings and beautifying sites,Large,1,48,15,33,224,223,1
2023,1,Tabuk Region,Activities providing services to buildings and beautifying sites,Micro,292,37,12,25,672,668,4
2023,1,Tabuk Region,Activities providing services to buildings and beautifying sites,Medium,10,195,96,99,843,840,3
2023,1,Jazan Region,Activities providing services to buildings and beautifying sites,Small,33,121,57,64,340,339,1
2023,1,Jazan Region,Activities providing services to buildings and beautifying sites,Micro,304,34,18,16,773,770,3
2023,1,Jazan Region,Activities providing services to buildings and beautifying sites,Medium,5,53,47,6,371,348,23
2023,1,Hail Region,Activities providing services to buildings and beautifying sites,Small,37,79,43,36,461,459,2
2023,1,Hail Region,Activities providing services to buildings and beautifying sites,Large,1,842,597,245,917,829,88
2023,1,Hail Region,Activities providing services to buildings and beautifying sites,Micro,302,37,18,19,698,689,9
2023,1,Hail Region,Activities providing services to buildings and beautifying sites,Medium,16,309,145,164,1386,1366,20
2023,1,Asir Region,Activities providing services to buildings and beautifying sites,Small,64,208,102,106,739,729,10
2023,1,Asir Region,Activities providing services to buildings and beautifying sites,Large,7,1599,1337,262,5136,5039,97
2023,1,Asir Region,Activities providing services to buildings and beautifying sites,Micro,471,78,45,33,1088,1080,8
2023,1,Asir Region,Activities providing services to buildings and beautifying sites,Medium,11,266,146,120,1071,1065,6
2023,1,Makkah Region,Activities providing services to buildings and beautifying sites,Small,845,2734,1288,1446,11078,10756,322
2023,1,Makkah Region,Activities providing services to buildings and beautifying sites,Large,62,11755,7398,4357,45585,44339,1246
2023,1,Makkah Region,Activities providing services to buildings and beautifying sites,Micro,2783,747,365,382,6474,6349,125
2023,1,Makkah Region,Activities providing services to buildings and beautifying sites,Medium,231,5110,2735,2375,20462,19613,849
2023,1,Najran Region,Activities providing services to buildings and beautifying sites,Small,40,107,49,58,541,536,5
2023,1,Najran Region,Activities providing services to buildings and beautifying sites,Large,8,1276,724,552,6842,6784,58
2023,1,Najran Region,Activities providing services to buildings and beautifying sites,Micro,167,18,9,9,400,391,9
2023,1,Najran Region,Activities providing services to buildings and beautifying sites,Medium,16,323,166,157,1285,1283,2
2023,1,Eastern Region,Publishing activities,Small,19,123,61,62,160,157,3
2023,1,Eastern Region,Publishing activities,Micro,65,37,13,24,117,116,1
2023,1,Eastern Region,Publishing activities,Medium,2,128,107,21,141,141,0
2023,1,Al Bahah Region,Publishing activities,Small,1,4,2,2,13,13,0
2023,1,Al Bahah Region,Publishing activities,Micro,6,2,2,0,11,11,0
2023,1,Al-Jawf Region,Publishing activities,Micro,2,0,0,0,4,4,0
2023,1,Northern border Region,Publishing activities,Micro,2,0,0,0,3,3,0
2023,1,Riyadh Region,Publishing activities,Small,76,593,280,313,579,564,15
2023,1,Riyadh Region,Publishing activities,Large,3,1492,511,981,1205,1092,113
2023,1,Riyadh Region,Publishing activities,Micro,201,166,64,102,279,269,10
2023,1,Riyadh Region,Publishing activities,Medium,8,600,260,340,304,294,10
2023,1,Qassim Region,Publishing activities,Small,1,0,0,0,35,35,0
2023,1,Qassim Region,Publishing activities,Micro,12,1,1,0,23,23,0
2023,1,Medina Region,Publishing activities,Small,3,10,6,4,10,10,0
2023,1,Medina Region,Publishing activities,Micro,14,5,1,4,28,28,0
2023,1,Tabuk Region,Publishing activities,Micro,3,1,1,0,7,7,0
2023,1,Jazan Region,Publishing activities,Micro,4,0,0,0,8,8,0
2023,1,Hail Region,Publishing activities,Small,1,3,1,2,8,8,0
2023,1,Hail Region,Publishing activities,Micro,24,3,0,3,77,77,0
2023,1,Asir Region,Publishing activities,Small,1,5,4,1,6,6,0
2023,1,Asir Region,Publishing activities,Micro,10,4,4,0,19,19,0
2023,1,Asir Region,Publishing activities,Medium,1,16,9,7,44,44,0
2023,1,Makkah Region,Publishing activities,Small,17,96,39,57,138,135,3
2023,1,Makkah Region,Publishing activities,Micro,102,56,20,36,162,159,3
2023,1,Makkah Region,Publishing activities,Medium,4,91,72,19,197,194,3
2023,1,Najran Region,Publishing activities,Micro,2,0,0,0,3,3,0
2023,1,Najran Region,Publishing activities,Medium,1,0,0,0,60,60,0
2023,1,Eastern Region,Activities of membership organizations,Small,14,100,35,65,65,61,4
2023,1,Eastern Region,Activities of membership organizations,Micro,66,62,37,25,83,80,3
2023,1,Eastern Region,Activities of membership organizations,Medium,1,86,43,43,74,70,4
2023,1,Al Bahah Region,Activities of membership organizations,Micro,15,22,18,4,8,8,0
2023,1,Al-Jawf Region,Activities of membership organizations,Small,3,32,25,7,10,10,0
2023,1,Al-Jawf Region,Activities of membership organizations,Micro,21,23,16,7,27,27,0
2023,1,Northern border Region,Activities of membership organizations,Small,1,2,2,0,13,13,0
2023,1,Northern border Region,Activities of membership organizations,Micro,6,9,8,1,2,2,0
2023,1,Riyadh Region,Activities of membership organizations,Small,73,425,215,210,504,481,23
2023,1,Riyadh Region,Activities of membership organizations,Micro,2178,298,168,130,5001,4932,69
2023,1,Riyadh Region,Activities of membership organizations,Medium,1,118,37,81,71,33,38
2023,1,Qassim Region,Activities of membership organizations,Small,11,72,31,41,43,42,1
2023,1,Qassim Region,Activities of membership organizations,Micro,72,60,46,14,111,111,0
2023,1,Medina Region,Activities of membership organizations,Small,8,62,47,15,44,44,0
2023,1,Medina Region,Activities of membership organizations,Micro,77,18,13,5,139,135,4
2023,1,Tabuk Region,Activities of membership organizations,Small,4,54,15,39,7,6,1
2023,1,Tabuk Region,Activities of membership organizations,Micro,15,13,8,5,19,18,1
2023,1,Tabuk Region,Activities of membership organizations,Medium,1,67,16,51,0,0,0
2023,1,Jazan Region,Activities of membership organizations,Small,8,86,34,52,32,30,2
2023,1,Jazan Region,Activities of membership organizations,Micro,128,45,23,22,231,227,4
2023,1,Jazan Region,Activities of membership organizations,Medium,2,96,38,58,12,12,0
2023,1,Hail Region,Activities of membership organizations,Small,5,35,22,13,15,15,0
2023,1,Hail Region,Activities of membership organizations,Micro,28,32,11,21,37,36,1
2023,1,Asir Region,Activities of membership organizations,Small,4,17,5,12,19,17,2
2023,1,Asir Region,Activities of membership organizations,Micro,34,28,20,8,33,30,3
2023,1,Asir Region,Activities of membership organizations,Medium,1,49,14,35,26,25,1
2023,1,Makkah Region,Activities of membership organizations,Small,23,161,108,53,159,159,0
2023,1,Makkah Region,Activities of membership organizations,Large,1,444,241,203,78,78,0
2023,1,Makkah Region,Activities of membership organizations,Micro,246,151,101,50,392,378,14
2023,1,Makkah Region,Activities of membership organizations,Medium,4,302,156,146,88,74,14
2023,1,Najran Region,Activities of membership organizations,Small,2,51,44,7,4,4,0
2023,1,Najran Region,Activities of membership organizations,Micro,30,21,15,6,43,42,1
2023,1,Eastern Region,"Activities of libraries, archives, museums and other cultural activities",Small,6,24,15,9,53,52,1
2023,1,Eastern Region,"Activities of libraries, archives, museums and other cultural activities",Micro,24,9,4,5,38,38,0
2023,1,Al Bahah Region,"Activities of libraries, archives, museums and other cultural activities",Micro,2,0,0,0,5,5,0
2023,1,Northern border Region,"Activities of libraries, archives, museums and other cultural activities",Micro,2,0,0,0,4,4,0
2023,1,Riyadh Region,"Activities of libraries, archives, museums and other cultural activities",Small,1,3,3,0,8,8,0
2023,1,Riyadh Region,"Activities of libraries, archives, museums and other cultural activities",Micro,20,9,5,4,42,41,1
2023,1,Qassim Region,"Activities of libraries, archives, museums and other cultural activities",Small,1,2,2,0,4,4,0
2023,1,Qassim Region,"Activities of libraries, archives, museums and other cultural activities",Micro,4,3,2,1,10,10,0
2023,1,Medina Region,"Activities of libraries, archives, museums and other cultural activities",Small,1,1,1,0,7,7,0
2023,1,Medina Region,"Activities of libraries, archives, museums and other cultural activities",Micro,26,11,7,4,44,44,0
2023,1,Tabuk Region,"Activities of libraries, archives, museums and other cultural activities",Micro,6,3,3,0,9,9,0
2023,1,Jazan Region,"Activities of libraries, archives, museums and other cultural activities",Micro,11,0,0,0,26,26,0
2023,1,Hail Region,"Activities of libraries, archives, museums and other cultural activities",Micro,4,0,0,0,4,4,0
2023,1,Asir Region,"Activities of libraries, archives, museums and other cultural activities",Micro,12,5,4,1,19,19,0
2023,1,Makkah Region,"Activities of libraries, archives, museums and other cultural activities",Small,4,3,2,1,23,23,0
2023,1,Makkah Region,"Activities of libraries, archives, museums and other cultural activities",Micro,66,20,14,6,108,107,1
2023,1,Makkah Region,"Activities of libraries, archives, museums and other cultural activities",Medium,1,64,37,27,96,96,0
2023,1,Najran Region,"Activities of libraries, archives, museums and other cultural activities",Micro,6,0,0,0,13,13,0
2023,1,Eastern Region,"Head office activities, and consulting activities in the field of management",Small,40,261,143,118,335,320,15
2023,1,Eastern Region,"Head office activities, and consulting activities in the field of management",Micro,110,97,53,44,130,123,7
2023,1,Eastern Region,"Head office activities, and consulting activities in the field of management",Medium,7,281,178,103,302,291,11
2023,1,Al Bahah Region,"Head office activities, and consulting activities in the field of management",Micro,2,1,0,1,3,3,0
2023,1,Al-Jawf Region,"Head office activities, and consulting activities in the field of management",Micro,1,1,0,1,1,1,0
2023,1,Al-Jawf Region,"Head office activities, and consulting activities in the field of management",Medium,1,18,1,17,32,29,3
2023,1,Northern border Region,"Head office activities, and consulting activities in the field of management",Micro,3,0,0,0,8,8,0
2023,1,Riyadh Region,"Head office activities, and consulting activities in the field of management",Small,250,1890,982,908,1823,1640,183
2023,1,Riyadh Region,"Head office activities, and consulting activities in the field of management",Large,11,12933,7461,5472,3710,3515,195
2023,1,Riyadh Region,"Head office activities, and consulting activities in the field of management",Micro,705,660,322,338,954,895,59
2023,1,Riyadh Region,"Head office activities, and consulting activities in the field of management",Medium,35,1945,1133,812,1798,1677,121
2023,1,Qassim Region,"Head office activities, and consulting activities in the field of management",Small,3,23,10,13,10,10,0
2023,1,Qassim Region,"Head office activities, and consulting activities in the field of management",Micro,15,10,6,4,22,20,2
2023,1,Qassim Region,"Head office activities, and consulting activities in the field of management",Medium,1,74,67,7,108,107,1
2023,1,Medina Region,"Head office activities, and consulting activities in the field of management",Small,4,47,26,21,8,8,0
2023,1,Medina Region,"Head office activities, and consulting activities in the field of management",Micro,31,21,9,12,46,45,1
2023,1,Tabuk Region,"Head office activities, and consulting activities in the field of management",Micro,2,1,1,0,1,1,0
2023,1,Jazan Region,"Head office activities, and consulting activities in the field of management",Micro,5,6,0,6,10,9,1
2023,1,Hail Region,"Head office activities, and consulting activities in the field of management",Micro,5,2,1,1,11,11,0
2023,1,Asir Region,"Head office activities, and consulting activities in the field of management",Micro,17,15,9,6,22,21,1
2023,1,Makkah Region,"Head office activities, and consulting activities in the field of management",Small,79,454,234,220,640,597,43
2023,1,Makkah Region,"Head office activities, and consulting activities in the field of management",Micro,247,200,100,100,348,328,20
2023,1,Makkah Region,"Head office activities, and consulting activities in the field of management",Medium,4,144,99,45,191,186,5
2023,1,Najran Region,"Head office activities, and consulting activities in the field of management",Micro,4,0,0,0,12,12,0
2023,1,Eastern Region,"Architectural engineering activities, technical testing and analysis",Small,266,1687,977,710,2386,2345,41
2023,1,Eastern Region,"Architectural engineering activities, technical testing and analysis",Large,23,5008,4020,988,6431,6406,25
2023,1,Eastern Region,"Architectural engineering activities, technical testing and analysis",Micro,466,368,219,149,823,813,10
2023,1,Eastern Region,"Architectural engineering activities, technical testing and analysis",Medium,70,2962,2211,751,3924,3907,17
2023,1,Al Bahah Region,"Architectural engineering activities, technical testing and analysis",Small,18,69,41,28,134,133,1
2023,1,Al Bahah Region,"Architectural engineering activities, technical testing and analysis",Micro,96,16,7,9,203,202,1
2023,1,Al-Jawf Region,"Architectural engineering activities, technical testing and analysis",Small,13,46,30,16,138,137,1
2023,1,Al-Jawf Region,"Architectural engineering activities, technical testing and analysis",Micro,104,36,22,14,214,212,2
2023,1,Northern border Region,"Architectural engineering activities, technical testing and analysis",Small,8,34,21,13,39,39,0
2023,1,Northern border Region,"Architectural engineering activities, technical testing and analysis",Micro,53,18,11,7,108,107,1
2023,1,Riyadh Region,"Architectural engineering activities, technical testing and analysis",Small,499,2911,1666,1245,4387,4288,99
2023,1,Riyadh Region,"Architectural engineering activities, technical testing and analysis",Large,28,6421,4369,2052,8696,8564,132
2023,1,Riyadh Region,"Architectural engineering activities, technical testing and analysis",Micro,3362,923,489,434,7433,7369,64
2023,1,Riyadh Region,"Architectural engineering activities, technical testing and analysis",Medium,113,5675,3510,2165,7401,7179,222
2023,1,Qassim Region,"Architectural engineering activities, technical testing and analysis",Small,41,206,131,75,334,332,2
2023,1,Qassim Region,"Architectural engineering activities, technical testing and analysis",Micro,168,74,56,18,316,316,0
2023,1,Qassim Region,"Architectural engineering activities, technical testing and analysis",Medium,5,206,133,73,224,223,1
2023,1,Medina Region,"Architectural engineering activities, technical testing and analysis",Small,72,313,178,135,622,616,6
2023,1,Medina Region,"Architectural engineering activities, technical testing and analysis",Large,1,153,82,71,179,178,1
2023,1,Medina Region,"Architectural engineering activities, technical testing and analysis",Micro,147,67,28,39,285,285,0
2023,1,Medina Region,"Architectural engineering activities, technical testing and analysis",Medium,7,376,267,109,443,443,0
2023,1,Tabuk Region,"Architectural engineering activities, technical testing and analysis",Small,21,100,77,23,171,171,0
2023,1,Tabuk Region,"Architectural engineering activities, technical testing and analysis",Micro,84,43,20,23,150,146,4
2023,1,Tabuk Region,"Architectural engineering activities, technical testing and analysis",Medium,1,44,19,25,31,31,0
2023,1,Jazan Region,"Architectural engineering activities, technical testing and analysis",Small,22,132,75,57,184,183,1
2023,1,Jazan Region,"Architectural engineering activities, technical testing and analysis",Micro,151,82,46,36,242,234,8
2023,1,Jazan Region,"Architectural engineering activities, technical testing and analysis",Medium,1,30,13,17,33,33,0
2023,1,Hail Region,"Architectural engineering activities, technical testing and analysis",Small,19,108,48,60,212,207,5
2023,1,Hail Region,"Architectural engineering activities, technical testing and analysis",Micro,165,25,20,5,386,386,0
2023,1,Hail Region,"Architectural engineering activities, technical testing and analysis",Medium,1,40,38,2,57,57,0
2023,1,Asir Region,"Architectural engineering activities, technical testing and analysis",Small,58,255,177,78,418,416,2
2023,1,Asir Region,"Architectural engineering activities, technical testing and analysis",Micro,258,144,88,56,482,480,2
2023,1,Asir Region,"Architectural engineering activities, technical testing and analysis",Medium,1,25,23,2,40,39,1
2023,1,Makkah Region,"Architectural engineering activities, technical testing and analysis",Small,396,1892,1091,801,3393,3339,54
2023,1,Makkah Region,"Architectural engineering activities, technical testing and analysis",Large,7,1198,837,361,1760,1746,14
2023,1,Makkah Region,"Architectural engineering activities, technical testing and analysis",Micro,962,594,332,262,1680,1645,35
2023,1,Makkah Region,"Architectural engineering activities, technical testing and analysis",Medium,27,1078,665,413,1564,1550,14
2023,1,Najran Region,"Architectural engineering activities, technical testing and analysis",Small,15,68,43,25,149,149,0
2023,1,Najran Region,"Architectural engineering activities, technical testing and analysis",Micro,155,29,14,15,352,350,2
2023,1,Eastern Region,Treatment activities and other waste management services,Small,7,25,10,15,78,77,1
2023,1,Eastern Region,Treatment activities and other waste management services,Micro,3,2,2,0,3,3,0
2023,1,Eastern Region,Treatment activities and other waste management services,Medium,1,29,28,1,59,59,0
2023,1,Riyadh Region,Treatment activities and other waste management services,Small,2,28,24,4,22,22,0
2023,1,Riyadh Region,Treatment activities and other waste management services,Large,1,1381,1112,269,14791,14462,329
2023,1,Riyadh Region,Treatment activities and other waste management services,Micro,5,3,1,2,11,11,0
2023,1,Medina Region,Treatment activities and other waste management services,Micro,1,0,0,0,2,2,0
2023,1,Jazan Region,Treatment activities and other waste management services,Micro,1,0,0,0,4,4,0
2023,1,Makkah Region,Treatment activities and other waste management services,Small,2,7,5,2,38,38,0
2023,1,Makkah Region,Treatment activities and other waste management services,Micro,1,1,0,1,2,2,0
2023,1,Najran Region,Treatment activities and other waste management services,Micro,1,1,0,1,1,1,0
2023,1,Eastern Region,"Social work activities, without residency",Small,195,2185,384,1801,458,384,74
2023,1,Eastern Region,"Social work activities, without residency",Large,2,317,141,176,405,293,112
2023,1,Eastern Region,"Social work activities, without residency",Micro,198,385,59,326,127,99,28
2023,1,Eastern Region,"Social work activities, without residency",Medium,20,1497,372,1125,441,296,145
2023,1,Al Bahah Region,"Social work activities, without residency",Small,31,284,151,133,97,88,9
2023,1,Al Bahah Region,"Social work activities, without residency",Micro,43,74,67,7,31,31,0
2023,1,Al Bahah Region,"Social work activities, without residency",Medium,1,50,11,39,0,0,0
2023,1,Al-Jawf Region,"Social work activities, without residency",Small,24,222,116,106,100,96,4
2023,1,Al-Jawf Region,"Social work activities, without residency",Micro,22,53,26,27,7,7,0
2023,1,Northern border Region,"Social work activities, without residency",Small,13,90,43,47,31,30,1
2023,1,Northern border Region,"Social work activities, without residency",Micro,25,50,27,23,16,15,1
2023,1,Riyadh Region,"Social work activities, without residency",Small,312,3255,844,2411,1617,1365,252
2023,1,Riyadh Region,"Social work activities, without residency",Large,7,1496,779,717,932,842,90
2023,1,Riyadh Region,"Social work activities, without residency",Micro,429,602,246,356,445,396,49
2023,1,Riyadh Region,"Social work activities, without residency",Medium,35,2363,1018,1345,1000,834,166
2023,1,Qassim Region,"Social work activities, without residency",Small,80,839,399,440,343,321,22
2023,1,Qassim Region,"Social work activities, without residency",Micro,107,169,98,71,93,91,2
2023,1,Qassim Region,"Social work activities, without residency",Medium,5,396,123,273,276,206,70
2023,1,Medina Region,"Social work activities, without residency",Small,75,797,359,438,242,215,27
2023,1,Medina Region,"Social work activities, without residency",Micro,165,347,178,169,106,89,17
2023,1,Medina Region,"Social work activities, without residency",Medium,13,683,288,395,296,212,84
2023,1,Tabuk Region,"Social work activities, without residency",Small,15,153,71,82,40,40,0
2023,1,Tabuk Region,"Social work activities, without residency",Micro,39,90,53,37,16,15,1
2023,1,Tabuk Region,"Social work activities, without residency",Medium,1,62,1,61,14,8,6
2023,1,Jazan Region,"Social work activities, without residency",Small,30,293,148,145,90,86,4
2023,1,Jazan Region,"Social work activities, without residency",Micro,67,128,80,48,42,41,1
2023,1,Jazan Region,"Social work activities, without residency",Medium,2,112,33,79,18,12,6
2023,1,Hail Region,"Social work activities, without residency",Small,18,239,107,132,32,30,2
2023,1,Hail Region,"Social work activities, without residency",Micro,69,103,66,37,62,62,0
2023,1,Hail Region,"Social work activities, without residency",Medium,1,49,2,47,4,2,2
2023,1,Asir Region,"Social work activities, without residency",Small,73,616,312,304,306,292,14
2023,1,Asir Region,"Social work activities, without residency",Micro,117,246,180,66,57,57,0
2023,1,Asir Region,"Social work activities, without residency",Medium,4,196,46,150,95,67,28
2023,1,Makkah Region,"Social work activities, without residency",Small,269,2710,887,1823,1163,896,267
2023,1,Makkah Region,"Social work activities, without residency",Micro,420,691,259,432,347,282,65
2023,1,Makkah Region,"Social work activities, without residency",Medium,22,1271,622,649,753,697,56
2023,1,Najran Region,"Social work activities, without residency",Small,12,77,29,48,77,73,4
2023,1,Najran Region,"Social work activities, without residency",Micro,35,60,33,27,38,37,1
2023,1,Eastern Region,"Financial services activities, except financing insurance and pension funds",Small,73,568,346,222,733,715,18
2023,1,Eastern Region,"Financial services activities, except financing insurance and pension funds",Large,2,891,534,357,156,142,14
2023,1,Eastern Region,"Financial services activities, except financing insurance and pension funds",Micro,181,121,77,44,280,275,5
2023,1,Eastern Region,"Financial services activities, except financing insurance and pension funds",Medium,19,1151,735,416,779,763,16
2023,1,Al Bahah Region,"Financial services activities, except financing insurance and pension funds",Micro,6,3,3,0,8,8,0
2023,1,Al-Jawf Region,"Financial services activities, except financing insurance and pension funds",Small,1,6,6,0,0,0,0
2023,1,Al-Jawf Region,"Financial services activities, except financing insurance and pension funds",Micro,8,2,2,0,8,8,0
2023,1,Northern border Region,"Financial services activities, except financing insurance and pension funds",Micro,4,0,0,0,12,12,0
2023,1,Northern border Region,"Financial services activities, except financing insurance and pension funds",Medium,1,0,0,0,55,55,0
2023,1,Riyadh Region,"Financial services activities, except financing insurance and pension funds",Small,200,1752,1068,684,1326,1280,46
2023,1,Riyadh Region,"Financial services activities, except financing insurance and pension funds",Large,13,21217,17132,4085,1357,1334,23
2023,1,Riyadh Region,"Financial services activities, except financing insurance and pension funds",Micro,466,469,309,160,621,594,27
2023,1,Riyadh Region,"Financial services activities, except financing insurance and pension funds",Medium,40,2710,1827,883,1567,1461,106
2023,1,Qassim Region,"Financial services activities, except financing insurance and pension funds",Small,6,23,20,3,59,59,0
2023,1,Qassim Region,"Financial services activities, except financing insurance and pension funds",Micro,26,6,3,3,46,46,0
2023,1,Medina Region,"Financial services activities, except financing insurance and pension funds",Small,4,35,34,1,22,22,0
2023,1,Medina Region,"Financial services activities, except financing insurance and pension funds",Large,1,208,174,34,89,88,1
2023,1,Medina Region,"Financial services activities, except financing insurance and pension funds",Micro,42,33,17,16,65,64,1
2023,1,Tabuk Region,"Financial services activities, except financing insurance and pension funds",Micro,14,2,2,0,25,25,0
2023,1,Jazan Region,"Financial services activities, except financing insurance and pension funds",Micro,16,1,0,1,35,35,0
2023,1,Hail Region,"Financial services activities, except financing insurance and pension funds",Micro,19,4,4,0,48,48,0
2023,1,Asir Region,"Financial services activities, except financing insurance and pension funds",Small,3,24,10,14,21,21,0
2023,1,Asir Region,"Financial services activities, except financing insurance and pension funds",Micro,25,8,4,4,36,35,1
2023,1,Makkah Region,"Financial services activities, except financing insurance and pension funds",Small,104,620,345,275,895,852,43
2023,1,Makkah Region,"Financial services activities, except financing insurance and pension funds",Large,2,2865,2342,523,257,254,3
2023,1,Makkah Region,"Financial services activities, except financing insurance and pension funds",Micro,346,202,136,66,596,576,20
2023,1,Makkah Region,"Financial services activities, except financing insurance and pension funds",Medium,19,1031,714,317,625,614,11
2023,1,Najran Region,"Financial services activities, except financing insurance and pension funds",Small,1,2,0,2,5,5,0
2023,1,Najran Region,"Financial services activities, except financing insurance and pension funds",Micro,11,3,1,2,22,22,0
2023,1,Eastern Region,Other personal service activities,Small,722,1446,324,1122,5524,3536,1988
2023,1,Eastern Region,Other personal service activities,Large,4,287,118,169,2243,2243,0
2023,1,Eastern Region,Other personal service activities,Micro,6669,1312,451,861,14618,13330,1288
2023,1,Eastern Region,Other personal service activities,Medium,12,250,92,158,950,915,35
2023,1,Al Bahah Region,Other personal service activities,Small,9,10,9,1,49,49,0
2023,1,Al Bahah Region,Other personal service activities,Micro,507,70,33,37,1014,948,66
2023,1,Al-Jawf Region,Other personal service activities,Small,40,65,38,27,322,290,32
2023,1,Al-Jawf Region,Other personal service activities,Micro,836,85,46,39,1736,1624,112
2023,1,Northern border Region,Other personal service activities,Small,21,28,8,20,147,98,49
2023,1,Northern border Region,Other personal service activities,Micro,639,63,26,37,1465,1366,99
2023,1,Riyadh Region,Other personal service activities,Small,1458,3445,768,2677,12343,7995,4348
2023,1,Riyadh Region,Other personal service activities,Large,3,1079,545,534,1483,1045,438
2023,1,Riyadh Region,Other personal service activities,Micro,10578,2159,710,1449,23161,20587,2574
2023,1,Riyadh Region,Other personal service activities,Medium,34,742,123,619,2169,1519,650
2023,1,Qassim Region,Other personal service activities,Small,132,236,50,186,1065,652,413
2023,1,Qassim Region,Other personal service activities,Micro,2270,245,98,147,4935,4573,362
2023,1,Qassim Region,Other personal service activities,Medium,4,69,34,35,260,202,58
2023,1,Medina Region,Other personal service activities,Small,156,324,71,253,1226,765,461
2023,1,Medina Region,Other personal service activities,Micro,2998,351,161,190,6121,5706,415
2023,1,Medina Region,Other personal service activities,Medium,1,41,4,37,110,5,105
2023,1,Tabuk Region,Other personal service activities,Small,42,75,15,60,364,282,82
2023,1,Tabuk Region,Other personal service activities,Micro,1529,169,72,97,3177,3010,167
2023,1,Tabuk Region,Other personal service activities,Medium,1,15,4,11,64,64,0
2023,1,Jazan Region,Other personal service activities,Small,39,101,14,87,295,164,131
2023,1,Jazan Region,Other personal service activities,Micro,2101,170,89,81,4498,4286,212
2023,1,Hail Region,Other personal service activities,Small,55,118,30,88,454,271,183
2023,1,Hail Region,Other personal service activities,Micro,1230,128,46,82,2694,2502,192
2023,1,Hail Region,Other personal service activities,Medium,1,36,1,35,57,7,50
2023,1,Asir Region,Other personal service activities,Small,109,173,69,104,788,633,155
2023,1,Asir Region,Other personal service activities,Micro,3032,373,161,212,6255,5905,350
2023,1,Makkah Region,Other personal service activities,Small,743,1770,403,1367,6233,3745,2488
2023,1,Makkah Region,Other personal service activities,Micro,9360,1524,582,942,20044,18180,1864
2023,1,Makkah Region,Other personal service activities,Medium,18,394,48,346,1029,291,738
2023,1,Najran Region,Other personal service activities,Small,23,40,13,27,170,137,33
2023,1,Najran Region,Other personal service activities,Micro,935,83,21,62,2051,1900,151
2023,1,Eastern Region,Specialized construction activities,Small,1974,5030,2513,2517,24273,24182,91
2023,1,Eastern Region,Specialized construction activities,Large,90,17436,14245,3191,69645,69482,163
2023,1,Eastern Region,Specialized construction activities,Micro,7108,1713,826,887,17792,17746,46
2023,1,Eastern Region,Specialized construction activities,Medium,258,5206,3264,1942,23322,23229,93
2023,1,Al Bahah Region,Specialized construction activities,Small,49,66,45,21,453,453,0
2023,1,Al Bahah Region,Specialized construction activities,Micro,544,87,57,30,1257,1256,1
2023,1,Al Bahah Region,Specialized construction activities,Medium,4,84,47,37,388,388,0
2023,1,Al-Jawf Region,Specialized construction activities,Small,59,100,66,34,648,632,16
2023,1,Al-Jawf Region,Specialized construction activities,Micro,714,92,61,31,1663,1658,5
2023,1,Al-Jawf Region,Specialized construction activities,Medium,5,59,39,20,361,360,1
2023,1,Northern border Region,Specialized construction activities,Small,35,60,31,29,282,280,2
2023,1,Northern border Region,Specialized construction activities,Micro,484,51,33,18,1290,1287,3
2023,1,Northern border Region,Specialized construction activities,Medium,2,38,37,1,232,232,0
2023,1,Riyadh Region,Specialized construction activities,Small,3160,8581,3683,4898,40640,40306,334
2023,1,Riyadh Region,Specialized construction activities,Large,158,32977,24533,8444,113815,111903,1912
2023,1,Riyadh Region,Specialized construction activities,Micro,12272,2874,1270,1604,29080,28841,239
2023,1,Riyadh Region,Specialized construction activities,Medium,532,9822,5421,4401,44636,44349,287
2023,1,Qassim Region,Specialized construction activities,Small,365,634,341,293,4453,4442,11
2023,1,Qassim Region,Specialized construction activities,Large,11,832,566,266,6286,6005,281
2023,1,Qassim Region,Specialized construction activities,Micro,2906,394,234,160,7176,7149,27
2023,1,Qassim Region,Specialized construction activities,Medium,47,321,195,126,4658,4658,0
2023,1,Medina Region,Specialized construction activities,Small,375,733,413,320,3904,3885,19
2023,1,Medina Region,Specialized construction activities,Large,9,1435,845,590,5401,5264,137
2023,1,Medina Region,Specialized construction activities,Micro,3271,514,284,230,8367,8320,47
2023,1,Medina Region,Specialized construction activities,Medium,22,360,203,157,1556,1548,8
2023,1,Tabuk Region,Specialized construction activities,Small,83,147,70,77,820,817,3
2023,1,Tabuk Region,Specialized construction activities,Large,1,97,87,10,702,702,0
2023,1,Tabuk Region,Specialized construction activities,Micro,1423,190,97,93,3511,3504,7
2023,1,Tabuk Region,Specialized construction activities,Medium,3,34,13,21,181,181,0
2023,1,Jazan Region,Specialized construction activities,Small,98,160,82,78,802,802,0
2023,1,Jazan Region,Specialized construction activities,Micro,2385,268,144,124,6136,6110,26
2023,1,Jazan Region,Specialized construction activities,Medium,2,37,27,10,243,243,0
2023,1,Hail Region,Specialized construction activities,Small,101,143,66,77,992,992,0
2023,1,Hail Region,Specialized construction activities,Large,2,205,152,53,773,769,4
2023,1,Hail Region,Specialized construction activities,Micro,1138,130,60,70,2807,2796,11
2023,1,Hail Region,Specialized construction activities,Medium,9,113,83,30,773,762,11
2023,1,Asir Region,Specialized construction activities,Small,311,608,337,271,3020,3004,16
2023,1,Asir Region,Specialized construction activities,Large,4,475,155,320,2512,2511,1
2023,1,Asir Region,Specialized construction activities,Micro,3167,436,220,216,7502,7488,14
2023,1,Asir Region,Specialized construction activities,Medium,13,288,187,101,889,888,1
2023,1,Makkah Region,Specialized construction activities,Small,1988,4914,2413,2501,22704,22515,189
2023,1,Makkah Region,Specialized construction activities,Large,52,5904,3855,2049,27512,27372,140
2023,1,Makkah Region,Specialized construction activities,Micro,11485,2259,1088,1171,27339,27041,298
2023,1,Makkah Region,Specialized construction activities,Medium,221,4315,2634,1681,18866,18775,91
2023,1,Najran Region,Specialized construction activities,Small,89,129,67,62,981,981,0
2023,1,Najran Region,Specialized construction activities,Large,3,305,247,58,3047,3044,3
2023,1,Najran Region,Specialized construction activities,Micro,1092,126,60,66,2417,2407,10
2023,1,Najran Region,Specialized construction activities,Medium,9,221,139,82,1008,1008,0
2023,1,Eastern Region,Postal activities and transportation of letters and parcels by couriers,Small,10,60,25,35,97,97,0
2023,1,Eastern Region,Postal activities and transportation of letters and parcels by couriers,Large,1,280,220,60,314,310,4
2023,1,Eastern Region,Postal activities and transportation of letters and parcels by couriers,Micro,26,20,8,12,32,32,0
2023,1,Eastern Region,Postal activities and transportation of letters and parcels by couriers,Medium,2,44,21,23,260,260,0
2023,1,Al Bahah Region,Postal activities and transportation of letters and parcels by couriers,Micro,1,1,1,0,0,0,0
2023,1,Al-Jawf Region,Postal activities and transportation of letters and parcels by couriers,Micro,1,0,0,0,4,4,0
2023,1,Northern border Region,Postal activities and transportation of letters and parcels by couriers,Micro,1,0,0,0,4,4,0
2023,1,Riyadh Region,Postal activities and transportation of letters and parcels by couriers,Small,103,418,166,252,1054,1028,26
2023,1,Riyadh Region,Postal activities and transportation of letters and parcels by couriers,Large,5,1120,619,501,3473,3446,27
2023,1,Riyadh Region,Postal activities and transportation of letters and parcels by couriers,Micro,262,127,63,64,500,486,14
2023,1,Riyadh Region,Postal activities and transportation of letters and parcels by couriers,Medium,22,634,351,283,1870,1845,25
2023,1,Qassim Region,Postal activities and transportation of letters and parcels by couriers,Small,1,1,0,1,6,6,0
2023,1,Qassim Region,Postal activities and transportation of letters and parcels by couriers,Micro,10,2,1,1,16,16,0
2023,1,Medina Region,Postal activities and transportation of letters and parcels by couriers,Small,2,3,2,1,9,9,0
2023,1,Medina Region,Postal activities and transportation of letters and parcels by couriers,Micro,15,4,2,2,28,28,0
2023,1,Medina Region,Postal activities and transportation of letters and parcels by couriers,Medium,1,80,80,0,127,127,0
2023,1,Tabuk Region,Postal activities and transportation of letters and parcels by couriers,Micro,9,1,0,1,24,23,1
2023,1,Jazan Region,Postal activities and transportation of letters and parcels by couriers,Small,1,9,8,1,24,24,0
2023,1,Jazan Region,Postal activities and transportation of letters and parcels by couriers,Micro,7,0,0,0,14,14,0
2023,1,Hail Region,Postal activities and transportation of letters and parcels by couriers,Micro,4,0,0,0,12,12,0
2023,1,Asir Region,Postal activities and transportation of letters and parcels by couriers,Small,3,10,4,6,11,11,0
2023,1,Asir Region,Postal activities and transportation of letters and parcels by couriers,Micro,9,3,2,1,26,26,0
2023,1,Makkah Region,Postal activities and transportation of letters and parcels by couriers,Small,30,113,54,59,247,244,3
2023,1,Makkah Region,Postal activities and transportation of letters and parcels by couriers,Large,3,1610,1386,224,2391,2391,0
2023,1,Makkah Region,Postal activities and transportation of letters and parcels by couriers,Micro,99,49,24,25,164,158,6
2023,1,Makkah Region,Postal activities and transportation of letters and parcels by couriers,Medium,6,111,38,73,324,324,0
2023,1,Najran Region,Postal activities and transportation of letters and parcels by couriers,Micro,3,0,0,0,4,4,0
2023,1,Eastern Region,Programming and broadcasting activities,Small,3,14,8,6,17,17,0
2023,1,Eastern Region,Programming and broadcasting activities,Micro,11,3,0,3,22,21,1
2023,1,Al-Jawf Region,Programming and broadcasting activities,Micro,1,0,0,0,1,1,0
2023,1,Riyadh Region,Programming and broadcasting activities,Small,12,34,18,16,75,73,2
2023,1,Riyadh Region,Programming and broadcasting activities,Micro,60,35,17,18,109,107,2
2023,1,Riyadh Region,Programming and broadcasting activities,Medium,4,197,117,80,209,178,31
2023,1,Qassim Region,Programming and broadcasting activities,Micro,2,0,0,0,3,3,0
2023,1,Medina Region,Programming and broadcasting activities,Micro,4,1,0,1,9,9,0
2023,1,Tabuk Region,Programming and broadcasting activities,Micro,2,0,0,0,5,5,0
2023,1,Jazan Region,Programming and broadcasting activities,Micro,1,1,0,1,3,3,0
2023,1,Hail Region,Programming and broadcasting activities,Small,1,2,1,1,5,5,0
2023,1,Asir Region,Programming and broadcasting activities,Micro,8,2,2,0,16,16,0
2023,1,Makkah Region,Programming and broadcasting activities,Small,10,71,46,25,86,85,1
2023,1,Makkah Region,Programming and broadcasting activities,Micro,23,6,1,5,49,48,1
2023,1,Makkah Region,Programming and broadcasting activities,Medium,1,57,29,28,70,70,0
2023,1,Najran Region,Programming and broadcasting activities,Micro,1,1,1,0,3,3,0
2023,1,Eastern Region,"Computer programming, consulting and related activities",Small,108,727,365,362,891,869,22
2023,1,Eastern Region,"Computer programming, consulting and related activities",Large,2,672,605,67,287,287,0
2023,1,Eastern Region,"Computer programming, consulting and related activities",Micro,292,249,118,131,416,408,8
2023,1,Eastern Region,"Computer programming, consulting and related activities",Medium,11,645,320,325,405,395,10
2023,1,Al Bahah Region,"Computer programming, consulting and related activities",Micro,4,3,2,1,6,6,0
2023,1,Al-Jawf Region,"Computer programming, consulting and related activities",Micro,11,9,4,5,25,25,0
2023,1,Northern border Region,"Computer programming, consulting and related activities",Micro,9,2,1,1,15,15,0
2023,1,Riyadh Region,"Computer programming, consulting and related activities",Small,628,4483,2101,2382,5555,5313,242
2023,1,Riyadh Region,"Computer programming, consulting and related activities",Large,25,15698,9717,5981,7465,7037,428
2023,1,Riyadh Region,"Computer programming, consulting and related activities",Micro,1471,1191,563,628,2180,2078,102
2023,1,Riyadh Region,"Computer programming, consulting and related activities",Medium,103,5100,3016,2084,4667,4521,146
2023,1,Qassim Region,"Computer programming, consulting and related activities",Small,9,53,35,18,75,75,0
2023,1,Qassim Region,"Computer programming, consulting and related activities",Micro,71,37,16,21,131,131,0
2023,1,Qassim Region,"Computer programming, consulting and related activities",Medium,1,32,7,25,24,24,0
2023,1,Medina Region,"Computer programming, consulting and related activities",Small,9,40,13,27,48,48,0
2023,1,Medina Region,"Computer programming, consulting and related activities",Micro,88,41,15,26,151,145,6
2023,1,Medina Region,"Computer programming, consulting and related activities",Medium,1,39,37,2,20,20,0
2023,1,Tabuk Region,"Computer programming, consulting and related activities",Small,1,5,4,1,13,13,0
2023,1,Tabuk Region,"Computer programming, consulting and related activities",Micro,20,6,2,4,39,39,0
2023,1,Jazan Region,"Computer programming, consulting and related activities",Small,1,1,1,0,7,7,0
2023,1,Jazan Region,"Computer programming, consulting and related activities",Micro,30,3,2,1,63,63,0
2023,1,Hail Region,"Computer programming, consulting and related activities",Small,2,4,1,3,17,17,0
2023,1,Hail Region,"Computer programming, consulting and related activities",Micro,14,6,3,3,26,26,0
2023,1,Asir Region,"Computer programming, consulting and related activities",Small,6,24,14,10,52,51,1
2023,1,Asir Region,"Computer programming, consulting and related activities",Micro,61,20,9,11,116,114,2
2023,1,Makkah Region,"Computer programming, consulting and related activities",Small,145,702,315,387,1158,1102,56
2023,1,Makkah Region,"Computer programming, consulting and related activities",Large,1,794,767,27,41,38,3
2023,1,Makkah Region,"Computer programming, consulting and related activities",Micro,606,376,183,193,967,922,45
2023,1,Makkah Region,"Computer programming, consulting and related activities",Medium,13,570,300,270,611,589,22
2023,1,Najran Region,"Computer programming, consulting and related activities",Micro,11,7,0,7,25,24,1
2023,1,Eastern Region,Security and investigation activities,Small,23,429,392,37,60,56,4
2023,1,Eastern Region,Security and investigation activities,Large,8,5158,4690,468,0,0,0
2023,1,Eastern Region,Security and investigation activities,Micro,53,88,78,10,51,51,0
2023,1,Eastern Region,Security and investigation activities,Medium,16,1419,1342,77,81,81,0
2023,1,Al Bahah Region,Security and investigation activities,Small,1,7,6,1,0,0,0
2023,1,Al-Jawf Region,Security and investigation activities,Small,2,59,44,15,0,0,0
2023,1,Al-Jawf Region,Security and investigation activities,Micro,7,12,11,1,3,3,0
2023,1,Northern border Region,Security and investigation activities,Small,1,17,12,5,0,0,0
2023,1,Northern border Region,Security and investigation activities,Large,1,0,0,0,331,331,0
2023,1,Northern border Region,Security and investigation activities,Micro,2,1,1,0,3,2,1
2023,1,Riyadh Region,Security and investigation activities,Small,53,749,610,139,191,189,2
2023,1,Riyadh Region,Security and investigation activities,Large,20,21061,19162,1899,180,178,2
2023,1,Riyadh Region,Security and investigation activities,Micro,110,129,91,38,128,127,1
2023,1,Riyadh Region,Security and investigation activities,Medium,21,2531,2293,238,107,104,3
2023,1,Qassim Region,Security and investigation activities,Small,3,87,84,3,1,1,0
2023,1,Qassim Region,Security and investigation activities,Micro,13,9,7,2,22,22,0
2023,1,Qassim Region,Security and investigation activities,Medium,1,52,47,5,9,5,4
2023,1,Medina Region,Security and investigation activities,Small,4,46,42,4,6,6,0
2023,1,Medina Region,Security and investigation activities,Micro,13,9,8,1,16,16,0
2023,1,Medina Region,Security and investigation activities,Medium,2,179,176,3,0,0,0
2023,1,Tabuk Region,Security and investigation activities,Micro,8,5,4,1,10,10,0
2023,1,Jazan Region,Security and investigation activities,Small,3,15,14,1,13,13,0
2023,1,Jazan Region,Security and investigation activities,Large,1,257,256,1,0,0,0
2023,1,Jazan Region,Security and investigation activities,Micro,9,4,3,1,13,13,0
2023,1,Hail Region,Security and investigation activities,Small,1,9,9,0,0,0,0
2023,1,Hail Region,Security and investigation activities,Micro,3,4,2,2,10,10,0
2023,1,Hail Region,Security and investigation activities,Medium,1,76,73,3,0,0,0
2023,1,Asir Region,Security and investigation activities,Small,4,74,68,6,0,0,0
2023,1,Asir Region,Security and investigation activities,Large,2,995,972,23,0,0,0
2023,1,Asir Region,Security and investigation activities,Micro,7,11,4,7,9,9,0
2023,1,Makkah Region,Security and investigation activities,Small,37,523,458,65,40,36,4
2023,1,Makkah Region,Security and investigation activities,Large,5,2651,2407,244,0,0,0
2023,1,Makkah Region,Security and investigation activities,Micro,70,62,49,13,85,82,3
2023,1,Makkah Region,Security and investigation activities,Medium,8,1142,981,161,74,74,0
2023,1,Najran Region,Security and investigation activities,Micro,2,1,0,1,4,4,0
2023,1,Najran Region,Security and investigation activities,Medium,1,236,209,27,1,1,0
2023,1,Eastern Region,Activities of households that employ individuals for domestic work,Small,1,3,0,3,8,8,0
2023,1,Eastern Region,Activities of households that employ individuals for domestic work,Micro,6,1,1,0,9,8,1
2023,1,Riyadh Region,Activities of households that employ individuals for domestic work,Micro,7,1,1,0,9,8,1
2023,1,Qassim Region,Activities of households that employ individuals for domestic work,Small,1,0,0,0,7,7,0
2023,1,Qassim Region,Activities of households that employ individuals for domestic work,Micro,5,1,1,0,10,10,0
2023,1,Medina Region,Activities of households that employ individuals for domestic work,Micro,1,0,0,0,3,3,0
2023,1,Jazan Region,Activities of households that employ individuals for domestic work,Micro,1,1,0,1,1,0,1
2023,1,Hail Region,Activities of households that employ individuals for domestic work,Micro,3,0,0,0,6,6,0
2023,1,Asir Region,Activities of households that employ individuals for domestic work,Small,1,0,0,0,7,7,0
2023,1,Makkah Region,Activities of households that employ individuals for domestic work,Micro,1,0,0,0,1,1,0
2023,1,Najran Region,Activities of households that employ individuals for domestic work,Micro,1,0,0,0,1,1,0
2023,1,Eastern Region,Usage activities,Small,49,257,124,133,373,252,121
2023,1,Eastern Region,Usage activities,Large,21,100,70,30,53655,39649,14006
2023,1,Eastern Region,Usage activities,Micro,291,310,167,143,352,331,21
2023,1,Eastern Region,Usage activities,Medium,11,503,375,128,916,484,432
2023,1,Al Bahah Region,Usage activities,Small,1,3,1,2,4,4,0
2023,1,Al Bahah Region,Usage activities,Micro,14,9,4,5,14,14,0
2023,1,Al-Jawf Region,Usage activities,Small,4,16,10,6,63,6,57
2023,1,Al-Jawf Region,Usage activities,Micro,28,33,10,23,27,27,0
2023,1,Northern border Region,Usage activities,Small,2,4,0,4,27,2,25
2023,1,Northern border Region,Usage activities,Micro,21,20,10,10,32,31,1
2023,1,Northern border Region,Usage activities,Medium,1,1,0,1,169,0,169
2023,1,Riyadh Region,Usage activities,Small,177,1118,426,692,1281,979,302
2023,1,Riyadh Region,Usage activities,Large,52,10566,1522,9044,201711,116320,85391
2023,1,Riyadh Region,Usage activities,Micro,760,651,324,327,1094,1050,44
2023,1,Riyadh Region,Usage activities,Medium,31,1615,830,785,1878,896,982
2023,1,Qassim Region,Usage activities,Small,23,106,37,69,434,190,244
2023,1,Qassim Region,Usage activities,Micro,79,73,38,35,108,107,1
2023,1,Qassim Region,Usage activities,Medium,1,10,2,8,184,5,179
2023,1,Medina Region,Usage activities,Small,12,51,23,28,146,25,121
2023,1,Medina Region,Usage activities,Micro,99,70,48,22,149,140,9
2023,1,Medina Region,Usage activities,Medium,1,0,0,0,57,0,57
2023,1,Tabuk Region,Usage activities,Small,5,18,10,8,16,16,0
2023,1,Tabuk Region,Usage activities,Micro,53,34,16,18,73,71,2
2023,1,Jazan Region,Usage activities,Small,2,3,0,3,39,39,0
2023,1,Jazan Region,Usage activities,Micro,42,15,9,6,77,77,0
2023,1,Hail Region,Usage activities,Small,6,41,15,26,27,26,1
2023,1,Hail Region,Usage activities,Micro,49,44,23,21,72,71,1
2023,1,Hail Region,Usage activities,Medium,1,1,1,0,89,0,89
2023,1,Asir Region,Usage activities,Small,13,28,9,19,123,16,107
2023,1,Asir Region,Usage activities,Large,2,0,0,0,15923,10443,5480
2023,1,Asir Region,Usage activities,Micro,124,82,47,35,182,181,1
2023,1,Asir Region,Usage activities,Medium,2,124,41,83,116,55,61
2023,1,Makkah Region,Usage activities,Small,51,222,93,129,394,268,126
2023,1,Makkah Region,Usage activities,Large,9,111,14,97,15108,12019,3089
2023,1,Makkah Region,Usage activities,Micro,386,273,160,113,584,565,19
2023,1,Makkah Region,Usage activities,Medium,6,113,43,70,372,158,214
2023,1,Najran Region,Usage activities,Small,5,10,6,4,54,32,22
2023,1,Najran Region,Usage activities,Micro,53,29,11,18,90,77,13
2023,1,Najran Region,Usage activities,Medium,2,6,0,6,192,10,182
2023,1,Eastern Region,Civil Engineering,Small,439,1615,852,763,6407,6383,24
2023,1,Eastern Region,Civil Engineering,Large,98,25599,20954,4645,112816,112641,175
2023,1,Eastern Region,Civil Engineering,Micro,566,294,157,137,1206,1201,5
2023,1,Eastern Region,Civil Engineering,Medium,180,4012,2809,1203,16883,16857,26
2023,1,Al Bahah Region,Civil Engineering,Small,4,10,9,1,39,39,0
2023,1,Al Bahah Region,Civil Engineering,Large,1,51,46,5,253,253,0
2023,1,Al Bahah Region,Civil Engineering,Micro,28,9,3,6,63,63,0
2023,1,Al Bahah Region,Civil Engineering,Medium,2,40,27,13,108,108,0
2023,1,Al-Jawf Region,Civil Engineering,Small,17,39,26,13,202,202,0
2023,1,Al-Jawf Region,Civil Engineering,Large,1,121,78,43,281,263,18
2023,1,Al-Jawf Region,Civil Engineering,Micro,46,10,8,2,100,100,0
2023,1,Al-Jawf Region,Civil Engineering,Medium,5,125,89,36,397,396,1
2023,1,Northern border Region,Civil Engineering,Small,7,33,20,13,119,119,0
2023,1,Northern border Region,Civil Engineering,Micro,39,10,4,6,96,95,1
2023,1,Northern border Region,Civil Engineering,Medium,1,38,20,18,128,128,0
2023,1,Riyadh Region,Civil Engineering,Small,680,2165,1039,1126,9529,9469,60
2023,1,Riyadh Region,Civil Engineering,Large,123,27473,18550,8923,125563,124890,673
2023,1,Riyadh Region,Civil Engineering,Micro,1284,515,238,277,2736,2709,27
2023,1,Riyadh Region,Civil Engineering,Medium,241,5103,3077,2026,23107,23045,62
2023,1,Qassim Region,Civil Engineering,Small,70,235,150,85,1103,1102,1
2023,1,Qassim Region,Civil Engineering,Large,11,1531,959,572,8428,8427,1
2023,1,Qassim Region,Civil Engineering,Micro,158,43,29,14,387,384,3
2023,1,Qassim Region,Civil Engineering,Medium,22,421,344,77,2036,2031,5
2023,1,Medina Region,Civil Engineering,Small,74,243,150,93,979,977,2
2023,1,Medina Region,Civil Engineering,Large,9,950,635,315,3932,3906,26
2023,1,Medina Region,Civil Engineering,Micro,187,52,29,23,445,443,2
2023,1,Medina Region,Civil Engineering,Medium,22,523,374,149,1884,1882,2
2023,1,Tabuk Region,Civil Engineering,Small,20,64,31,33,261,261,0
2023,1,Tabuk Region,Civil Engineering,Large,1,101,50,51,496,496,0
2023,1,Tabuk Region,Civil Engineering,Micro,78,21,8,13,167,166,1
2023,1,Tabuk Region,Civil Engineering,Medium,4,83,55,28,300,300,0
2023,1,Jazan Region,Civil Engineering,Small,22,45,20,25,325,324,1
2023,1,Jazan Region,Civil Engineering,Large,1,59,52,7,326,326,0
2023,1,Jazan Region,Civil Engineering,Micro,107,23,10,13,264,264,0
2023,1,Jazan Region,Civil Engineering,Medium,6,147,90,57,639,639,0
2023,1,Hail Region,Civil Engineering,Small,25,68,42,26,311,310,1
2023,1,Hail Region,Civil Engineering,Large,1,125,79,46,641,641,0
2023,1,Hail Region,Civil Engineering,Micro,70,13,6,7,175,173,2
2023,1,Hail Region,Civil Engineering,Medium,7,154,117,37,649,645,4
2023,1,Asir Region,Civil Engineering,Small,55,145,79,66,630,628,2
2023,1,Asir Region,Civil Engineering,Large,8,682,560,122,3499,3499,0
2023,1,Asir Region,Civil Engineering,Micro,151,49,29,20,361,361,0
2023,1,Asir Region,Civil Engineering,Medium,26,594,432,162,2388,2387,1
2023,1,Makkah Region,Civil Engineering,Small,342,1183,621,562,4643,4612,31
2023,1,Makkah Region,Civil Engineering,Large,38,7335,5319,2016,34802,34710,92
2023,1,Makkah Region,Civil Engineering,Micro,686,246,126,120,1551,1530,21
2023,1,Makkah Region,Civil Engineering,Medium,97,2034,1315,719,8584,8551,33
2023,1,Najran Region,Civil Engineering,Small,21,80,36,44,304,304,0
2023,1,Najran Region,Civil Engineering,Large,6,845,600,245,3401,3401,0
2023,1,Najran Region,Civil Engineering,Micro,61,19,7,12,141,140,1
2023,1,Najran Region,Civil Engineering,Medium,9,137,79,58,706,704,2
2023,1,Eastern Region,Water transportation,Small,28,166,119,47,230,225,5
2023,1,Eastern Region,Water transportation,Micro,47,38,33,5,69,69,0
2023,1,Eastern Region,Water transportation,Medium,13,793,629,164,364,357,7
2023,1,Al Bahah Region,Water transportation,Micro,1,0,0,0,2,2,0
2023,1,Northern border Region,Water transportation,Micro,1,0,0,0,1,1,0
2023,1,Riyadh Region,Water transportation,Small,17,130,60,70,173,172,1
2023,1,Riyadh Region,Water transportation,Micro,119,33,19,14,273,269,4
2023,1,Riyadh Region,Water transportation,Medium,2,173,150,23,73,72,1
2023,1,Qassim Region,Water transportation,Small,1,0,0,0,8,8,0
2023,1,Qassim Region,Water transportation,Micro,5,1,0,1,11,11,0
2023,1,Medina Region,Water transportation,Small,6,37,29,8,45,45,0
2023,1,Medina Region,Water transportation,Micro,22,15,10,5,35,35,0
2023,1,Medina Region,Water transportation,Medium,2,62,46,16,58,56,2
2023,1,Tabuk Region,Water transportation,Small,2,7,3,4,27,15,12
2023,1,Tabuk Region,Water transportation,Micro,13,8,8,0,20,20,0
2023,1,Jazan Region,Water transportation,Small,3,50,33,17,14,14,0
2023,1,Jazan Region,Water transportation,Micro,13,5,3,2,24,24,0
2023,1,Hail Region,Water transportation,Micro,4,3,1,2,5,5,0
2023,1,Asir Region,Water transportation,Micro,13,1,1,0,34,34,0
2023,1,Makkah Region,Water transportation,Small,37,188,133,55,293,287,6
2023,1,Makkah Region,Water transportation,Micro,122,45,22,23,206,202,4
2023,1,Makkah Region,Water transportation,Medium,5,176,114,62,195,194,1
2023,1,Najran Region,Water transportation,Small,1,0,0,0,6,6,0
2023,1,Najran Region,Water transportation,Micro,5,0,0,0,9,9,0
2023,1,Eastern Region,Air transportation,Small,16,103,78,25,119,118,1
2023,1,Eastern Region,Air transportation,Micro,61,17,9,8,110,110,0
2023,1,Al-Jawf Region,Air transportation,Small,1,0,0,0,8,8,0
2023,1,Al-Jawf Region,Air transportation,Micro,7,1,1,0,18,18,0
2023,1,Northern border Region,Air transportation,Small,2,11,8,3,25,25,0
2023,1,Riyadh Region,Air transportation,Small,22,131,88,43,231,231,0
2023,1,Riyadh Region,Air transportation,Large,2,1742,1597,145,1406,786,620
2023,1,Riyadh Region,Air transportation,Micro,223,43,25,18,562,558,4
2023,1,Riyadh Region,Air transportation,Medium,7,282,216,66,272,238,34
2023,1,Qassim Region,Air transportation,Small,1,1,0,1,5,5,0
2023,1,Qassim Region,Air transportation,Micro,10,3,1,2,19,19,0
2023,1,Medina Region,Air transportation,Small,2,25,23,2,20,20,0
2023,1,Medina Region,Air transportation,Micro,10,3,2,1,22,22,0
2023,1,Tabuk Region,Air transportation,Small,2,16,13,3,30,30,0
2023,1,Tabuk Region,Air transportation,Micro,6,0,0,0,11,11,0
2023,1,Jazan Region,Air transportation,Micro,11,1,1,0,27,27,0
2023,1,Hail Region,Air transportation,Micro,16,0,0,0,46,45,1
2023,1,Asir Region,Air transportation,Small,1,0,0,0,7,7,0
2023,1,Asir Region,Air transportation,Micro,12,6,4,2,24,24,0
2023,1,Makkah Region,Air transportation,Small,25,179,133,46,248,241,7
2023,1,Makkah Region,Air transportation,Large,2,5949,5353,596,258,130,128
2023,1,Makkah Region,Air transportation,Micro,86,55,36,19,162,161,1
2023,1,Makkah Region,Air transportation,Medium,3,122,95,27,119,119,0
2023,1,Najran Region,Air transportation,Micro,2,0,0,0,5,5,0
2023,1,Eastern Region,Land transportation and pipeline transportation,Small,822,2883,1570,1313,12125,12112,13
2023,1,Eastern Region,Land transportation and pipeline transportation,Large,51,9121,7438,1683,23519,23509,10
2023,1,Eastern Region,Land transportation and pipeline transportation,Micro,2016,547,259,288,4103,4092,11
2023,1,Eastern Region,Land transportation and pipeline transportation,Medium,218,4952,3201,1751,16374,16353,21
2023,1,Al Bahah Region,Land transportation and pipeline transportation,Small,8,23,11,12,167,167,0
2023,1,Al Bahah Region,Land transportation and pipeline transportation,Micro,183,40,27,13,376,375,1
2023,1,Al-Jawf Region,Land transportation and pipeline transportation,Small,88,176,109,67,1024,1024,0
2023,1,Al-Jawf Region,Land transportation and pipeline transportation,Micro,570,54,33,21,1240,1234,6
2023,1,Al-Jawf Region,Land transportation and pipeline transportation,Medium,8,133,58,75,504,504,0
2023,1,Northern border Region,Land transportation and pipeline transportation,Small,66,155,70,85,746,746,0
2023,1,Northern border Region,Land transportation and pipeline transportation,Micro,317,37,21,16,624,624,0
2023,1,Northern border Region,Land transportation and pipeline transportation,Medium,1,50,36,14,152,152,0
2023,1,Riyadh Region,Land transportation and pipeline transportation,Small,1266,3642,1527,2115,16153,16097,56
2023,1,Riyadh Region,Land transportation and pipeline transportation,Large,59,18597,15922,2675,31538,31515,23
2023,1,Riyadh Region,Land transportation and pipeline transportation,Micro,13719,1605,720,885,36819,36651,168
2023,1,Riyadh Region,Land transportation and pipeline transportation,Medium,240,5427,2926,2501,19368,19341,27
2023,1,Qassim Region,Land transportation and pipeline transportation,Small,275,759,393,366,3280,3271,9
2023,1,Qassim Region,Land transportation and pipeline transportation,Large,7,638,550,88,2164,2164,0
2023,1,Qassim Region,Land transportation and pipeline transportation,Micro,1151,211,107,104,2576,2572,4
2023,1,Qassim Region,Land transportation and pipeline transportation,Medium,32,627,395,232,2377,2369,8
2023,1,Medina Region,Land transportation and pipeline transportation,Small,164,412,216,196,1976,1976,0
2023,1,Medina Region,Land transportation and pipeline transportation,Large,1,101,40,61,309,309,0
2023,1,Medina Region,Land transportation and pipeline transportation,Micro,1037,146,80,66,2120,2118,2
2023,1,Medina Region,Land transportation and pipeline transportation,Medium,25,499,336,163,1652,1652,0
2023,1,Tabuk Region,Land transportation and pipeline transportation,Small,73,137,57,80,698,697,1
2023,1,Tabuk Region,Land transportation and pipeline transportation,Large,1,71,65,6,195,195,0
2023,1,Tabuk Region,Land transportation and pipeline transportation,Micro,618,83,47,36,1249,1247,2
2023,1,Tabuk Region,Land transportation and pipeline transportation,Medium,6,156,115,41,245,245,0
2023,1,Jazan Region,Land transportation and pipeline transportation,Small,36,75,39,36,377,376,1
2023,1,Jazan Region,Land transportation and pipeline transportation,Large,2,822,629,193,300,286,14
2023,1,Jazan Region,Land transportation and pipeline transportation,Micro,587,70,38,32,1340,1331,9
2023,1,Jazan Region,Land transportation and pipeline transportation,Medium,6,89,35,54,398,398,0
2023,1,Hail Region,Land transportation and pipeline transportation,Small,59,108,52,56,612,612,0
2023,1,Hail Region,Land transportation and pipeline transportation,Micro,668,72,34,38,1705,1702,3
2023,1,Hail Region,Land transportation and pipeline transportation,Medium,3,30,10,20,129,129,0
2023,1,Asir Region,Land transportation and pipeline transportation,Small,283,712,422,290,3102,3093,9
2023,1,Asir Region,Land transportation and pipeline transportation,Large,2,131,106,25,394,394,0
2023,1,Asir Region,Land transportation and pipeline transportation,Micro,1836,254,132,122,3722,3715,7
2023,1,Asir Region,Land transportation and pipeline transportation,Medium,16,391,255,136,1223,1223,0
2023,1,Makkah Region,Land transportation and pipeline transportation,Small,1015,3235,1533,1702,13114,13059,55
2023,1,Makkah Region,Land transportation and pipeline transportation,Large,24,3633,2669,964,11416,11372,44
2023,1,Makkah Region,Land transportation and pipeline transportation,Micro,3715,695,361,334,8078,7989,89
2023,1,Makkah Region,Land transportation and pipeline transportation,Medium,148,3318,1943,1375,10904,10844,60
2023,1,Najran Region,Land transportation and pipeline transportation,Small,103,209,92,117,1213,1212,1
2023,1,Najran Region,Land transportation and pipeline transportation,Micro,995,75,34,41,2508,2502,6
2023,1,Najran Region,Land transportation and pipeline transportation,Medium,5,104,72,32,381,381,0
2023,1,Eastern Region,Printing and reproduction of recorded media,Small,55,242,100,142,586,585,1
2023,1,Eastern Region,Printing and reproduction of recorded media,Large,1,491,337,154,367,362,5
2023,1,Eastern Region,Printing and reproduction of recorded media,Micro,89,60,30,30,152,149,3
2023,1,Eastern Region,Printing and reproduction of recorded media,Medium,3,63,24,39,191,191,0
2023,1,Al Bahah Region,Printing and reproduction of recorded media,Small,3,4,2,2,15,15,0
2023,1,Al Bahah Region,Printing and reproduction of recorded media,Micro,7,4,2,2,13,13,0
2023,1,Al-Jawf Region,Printing and reproduction of recorded media,Micro,11,3,2,1,21,21,0
2023,1,Northern border Region,Printing and reproduction of recorded media,Small,2,2,0,2,10,10,0
2023,1,Northern border Region,Printing and reproduction of recorded media,Micro,5,1,1,0,10,10,0
2023,1,Riyadh Region,Printing and reproduction of recorded media,Small,158,824,308,516,1819,1805,14
2023,1,Riyadh Region,Printing and reproduction of recorded media,Micro,269,143,62,81,467,461,6
2023,1,Riyadh Region,Printing and reproduction of recorded media,Medium,13,465,256,209,864,860,4
2023,1,Qassim Region,Printing and reproduction of recorded media,Small,10,66,22,44,126,126,0
2023,1,Qassim Region,Printing and reproduction of recorded media,Micro,29,16,9,7,57,56,1
2023,1,Qassim Region,Printing and reproduction of recorded media,Medium,1,16,7,9,49,49,0
2023,1,Medina Region,Printing and reproduction of recorded media,Small,12,29,10,19,93,92,1
2023,1,Medina Region,Printing and reproduction of recorded media,Micro,38,13,10,3,85,85,0
2023,1,Tabuk Region,Printing and reproduction of recorded media,Small,6,14,5,9,54,53,1
2023,1,Tabuk Region,Printing and reproduction of recorded media,Micro,16,11,4,7,32,32,0
2023,1,Jazan Region,Printing and reproduction of recorded media,Small,2,8,4,4,14,14,0
2023,1,Jazan Region,Printing and reproduction of recorded media,Micro,12,2,1,1,27,27,0
2023,1,Hail Region,Printing and reproduction of recorded media,Small,3,9,5,4,30,30,0
2023,1,Hail Region,Printing and reproduction of recorded media,Micro,18,5,3,2,35,35,0
2023,1,Asir Region,Printing and reproduction of recorded media,Small,7,33,16,17,76,76,0
2023,1,Asir Region,Printing and reproduction of recorded media,Micro,28,18,11,7,52,51,1
2023,1,Makkah Region,Printing and reproduction of recorded media,Small,79,365,160,205,867,862,5
2023,1,Makkah Region,Printing and reproduction of recorded media,Micro,196,63,33,30,368,357,11
2023,1,Makkah Region,Printing and reproduction of recorded media,Medium,7,184,71,113,345,340,5
2023,1,Najran Region,Printing and reproduction of recorded media,Small,1,6,3,3,14,14,0
2023,1,Najran Region,Printing and reproduction of recorded media,Micro,9,4,3,1,24,24,0
2023,1,Eastern Region,Other manufacturing industries,Small,85,398,289,109,1116,1111,5
2023,1,Eastern Region,Other manufacturing industries,Large,6,914,843,71,1573,1569,4
2023,1,Eastern Region,Other manufacturing industries,Micro,102,72,48,24,182,178,4
2023,1,Eastern Region,Other manufacturing industries,Medium,24,538,356,182,1465,1461,4
2023,1,Al Bahah Region,Other manufacturing industries,Small,1,1,1,0,5,5,0
2023,1,Al Bahah Region,Other manufacturing industries,Micro,9,3,2,1,21,20,1
2023,1,Al-Jawf Region,Other manufacturing industries,Small,2,1,1,0,19,19,0
2023,1,Al-Jawf Region,Other manufacturing industries,Micro,7,1,1,0,11,11,0
2023,1,Northern border Region,Other manufacturing industries,Micro,4,0,0,0,10,10,0
2023,1,Riyadh Region,Other manufacturing industries,Small,177,780,333,447,2876,2729,147
2023,1,Riyadh Region,Other manufacturing industries,Large,6,711,262,449,2162,2140,22
2023,1,Riyadh Region,Other manufacturing industries,Micro,198,99,54,45,435,423,12
2023,1,Riyadh Region,Other manufacturing industries,Medium,59,1424,838,586,4321,4263,58
2023,1,Qassim Region,Other manufacturing industries,Small,7,42,33,9,94,94,0
2023,1,Qassim Region,Other manufacturing industries,Micro,22,13,13,0,39,39,0
2023,1,Qassim Region,Other manufacturing industries,Medium,4,119,32,87,344,344,0
2023,1,Medina Region,Other manufacturing industries,Small,7,20,13,7,73,72,1
2023,1,Medina Region,Other manufacturing industries,Micro,31,16,10,6,52,51,1
2023,1,Tabuk Region,Other manufacturing industries,Small,2,9,4,5,14,14,0
2023,1,Tabuk Region,Other manufacturing industries,Micro,11,2,2,0,25,22,3
2023,1,Jazan Region,Other manufacturing industries,Small,3,6,3,3,25,25,0
2023,1,Jazan Region,Other manufacturing industries,Micro,17,5,4,1,39,39,0
2023,1,Hail Region,Other manufacturing industries,Small,2,6,5,1,11,11,0
2023,1,Hail Region,Other manufacturing industries,Micro,15,4,3,1,36,35,1
2023,1,Asir Region,Other manufacturing industries,Small,17,47,29,18,178,174,4
2023,1,Asir Region,Other manufacturing industries,Micro,32,16,14,2,70,67,3
2023,1,Makkah Region,Other manufacturing industries,Small,108,490,214,276,1498,1477,21
2023,1,Makkah Region,Other manufacturing industries,Large,7,887,628,259,2711,2696,15
2023,1,Makkah Region,Other manufacturing industries,Micro,169,84,47,37,325,313,12
2023,1,Makkah Region,Other manufacturing industries,Medium,22,515,300,215,1713,1708,5
2023,1,Najran Region,Other manufacturing industries,Small,2,10,4,6,17,13,4
2023,1,Najran Region,Other manufacturing industries,Micro,5,5,4,1,10,10,0
2023,1,Eastern Region,Sanitation,Small,19,47,21,26,264,261,3
2023,1,Eastern Region,Sanitation,Large,3,325,206,119,1855,1855,0
2023,1,Eastern Region,Sanitation,Micro,33,21,10,11,82,81,1
2023,1,Eastern Region,Sanitation,Medium,4,55,27,28,310,306,4
2023,1,Al Bahah Region,Sanitation,Micro,4,1,0,1,17,17,0
2023,1,Al-Jawf Region,Sanitation,Micro,9,0,0,0,14,14,0
2023,1,Northern border Region,Sanitation,Micro,4,0,0,0,10,10,0
2023,1,Riyadh Region,Sanitation,Small,28,52,27,25,341,339,2
2023,1,Riyadh Region,Sanitation,Large,1,1581,1190,391,8066,8051,15
2023,1,Riyadh Region,Sanitation,Micro,113,19,11,8,251,250,1
2023,1,Riyadh Region,Sanitation,Medium,6,118,78,40,671,671,0
2023,1,Qassim Region,Sanitation,Small,5,13,7,6,69,68,1
2023,1,Qassim Region,Sanitation,Micro,27,7,7,0,62,62,0
2023,1,Qassim Region,Sanitation,Medium,1,21,18,3,107,107,0
2023,1,Medina Region,Sanitation,Small,12,14,9,5,123,123,0
2023,1,Medina Region,Sanitation,Micro,11,1,1,0,25,25,0
2023,1,Medina Region,Sanitation,Medium,1,101,101,0,24,24,0
2023,1,Tabuk Region,Sanitation,Small,1,1,0,1,7,7,0
2023,1,Tabuk Region,Sanitation,Micro,5,2,1,1,12,11,1
2023,1,Jazan Region,Sanitation,Small,1,2,1,1,6,6,0
2023,1,Jazan Region,Sanitation,Micro,26,4,3,1,59,59,0
2023,1,Hail Region,Sanitation,Small,5,19,16,3,70,70,0
2023,1,Hail Region,Sanitation,Micro,12,1,1,0,23,23,0
2023,1,Hail Region,Sanitation,Medium,1,12,9,3,61,61,0
2023,1,Asir Region,Sanitation,Small,2,3,2,1,37,37,0
2023,1,Asir Region,Sanitation,Micro,10,2,1,1,21,21,0
2023,1,Asir Region,Sanitation,Medium,1,21,15,6,63,63,0
2023,1,Makkah Region,Sanitation,Small,20,28,16,12,234,232,2
2023,1,Makkah Region,Sanitation,Large,1,329,294,35,1549,1549,0
2023,1,Makkah Region,Sanitation,Micro,80,30,18,12,187,186,1
2023,1,Makkah Region,Sanitation,Medium,5,104,87,17,282,281,1
2023,1,Najran Region,Sanitation,Micro,3,0,0,0,3,3,0
2023,1,Eastern Region,Human health,Small,341,2625,609,2016,4546,2218,2328
2023,1,Eastern Region,Human health,Large,32,9501,3385,6116,15010,6688,8322
2023,1,Eastern Region,Human health,Micro,206,218,65,153,340,238,102
2023,1,Eastern Region,Human health,Medium,108,4293,1067,3226,7112,3842,3270
2023,1,Al Bahah Region,Human health,Small,33,218,75,143,394,164,230
2023,1,Al Bahah Region,Human health,Micro,22,19,9,10,35,24,11
2023,1,Al Bahah Region,Human health,Medium,2,35,13,22,71,29,42
2023,1,Al-Jawf Region,Human health,Small,42,274,86,188,459,244,215
2023,1,Al-Jawf Region,Human health,Micro,26,25,8,17,44,33,11
2023,1,Al-Jawf Region,Human health,Medium,8,202,57,145,366,195,171
2023,1,Northern border Region,Human health,Small,33,174,40,134,376,212,164
2023,1,Northern border Region,Human health,Micro,19,22,6,16,34,24,10
2023,1,Northern border Region,Human health,Medium,6,131,38,93,256,124,132
2023,1,Riyadh Region,Human health,Small,951,6743,1955,4788,12834,6213,6621
2023,1,Riyadh Region,Human health,Large,79,12557,4917,7640,58464,45418,13046
2023,1,Riyadh Region,Human health,Micro,645,485,176,309,1050,704,346
2023,1,Riyadh Region,Human health,Medium,287,8898,2606,6292,17854,9141,8713
2023,1,Qassim Region,Human health,Small,117,918,308,610,1526,626,900
2023,1,Qassim Region,Human health,Large,6,722,351,371,2730,1877,853
2023,1,Qassim Region,Human health,Micro,67,44,27,17,113,80,33
2023,1,Qassim Region,Human health,Medium,29,794,320,474,1808,847,961
2023,1,Medina Region,Human health,Small,173,1293,375,918,2221,1005,1216
2023,1,Medina Region,Human health,Large,10,1496,613,883,2903,1518,1385
2023,1,Medina Region,Human health,Micro,87,77,41,36,138,87,51
2023,1,Medina Region,Human health,Medium,30,765,238,527,1432,646,786
2023,1,Tabuk Region,Human health,Small,66,438,107,331,726,358,368
2023,1,Tabuk Region,Human health,Large,1,115,57,58,221,135,86
2023,1,Tabuk Region,Human health,Micro,30,20,3,17,53,46,7
2023,1,Tabuk Region,Human health,Medium,14,420,84,336,694,370,324
2023,1,Jazan Region,Human health,Small,107,869,201,668,1184,529,655
2023,1,Jazan Region,Human health,Large,2,340,142,198,721,260,461
2023,1,Jazan Region,Human health,Micro,73,55,18,37,120,99,21
2023,1,Jazan Region,Human health,Medium,19,624,167,457,1076,584,492
2023,1,Hail Region,Human health,Small,59,326,91,235,655,334,321
2023,1,Hail Region,Human health,Large,2,274,96,178,591,250,341
2023,1,Hail Region,Human health,Micro,51,42,14,28,99,77,22
2023,1,Hail Region,Human health,Medium,17,597,180,417,1104,539,565
2023,1,Asir Region,Human health,Small,210,1536,425,1111,2573,1128,1445
2023,1,Asir Region,Human health,Large,6,1188,508,680,3694,2438,1256
2023,1,Asir Region,Human health,Micro,105,94,28,66,176,133,43
2023,1,Asir Region,Human health,Medium,38,1245,348,897,2327,1083,1244
2023,1,Makkah Region,Human health,Small,730,5730,1483,4247,8845,4193,4652
2023,1,Makkah Region,Human health,Large,31,6814,2496,4318,13125,6505,6620
2023,1,Makkah Region,Human health,Micro,435,372,132,240,693,507,186
2023,1,Makkah Region,Human health,Medium,182,6089,1666,4423,11406,5631,5775
2023,1,Najran Region,Human health,Small,62,380,148,232,765,372,393
2023,1,Najran Region,Human health,Large,3,179,127,52,611,449,162
2023,1,Najran Region,Human health,Micro,37,21,12,9,69,46,23
2023,1,Najran Region,Human health,Medium,7,242,112,130,467,251,216
2023,1,Eastern Region,Care with residence,Small,14,216,12,204,80,39,41
2023,1,Eastern Region,Care with residence,Micro,2,5,0,5,0,0,0
2023,1,Eastern Region,Care with residence,Medium,1,53,12,41,77,55,22
2023,1,Al-Jawf Region,Care with residence,Small,2,57,0,57,0,0,0
2023,1,Al-Jawf Region,Care with residence,Micro,2,1,0,1,1,1,0
2023,1,Riyadh Region,Care with residence,Small,27,531,67,464,134,68,66
2023,1,Riyadh Region,Care with residence,Micro,15,14,6,8,21,15,6
2023,1,Riyadh Region,Care with residence,Medium,6,409,55,354,199,128,71
2023,1,Qassim Region,Care with residence,Small,1,12,0,12,4,0,4
2023,1,Qassim Region,Care with residence,Micro,1,1,0,1,0,0,0
2023,1,Qassim Region,Care with residence,Medium,4,220,61,159,79,55,24
2023,1,Medina Region,Care with residence,Small,5,97,34,63,36,27,9
2023,1,Medina Region,Care with residence,Micro,4,8,7,1,3,3,0
2023,1,Tabuk Region,Care with residence,Small,3,57,2,55,9,5,4
2023,1,Tabuk Region,Care with residence,Medium,1,44,1,43,10,5,5
2023,1,Jazan Region,Care with residence,Small,2,44,1,43,4,0,4
2023,1,Jazan Region,Care with residence,Micro,1,3,0,3,0,0,0
2023,1,Jazan Region,Care with residence,Medium,1,62,1,61,11,4,7
2023,1,Hail Region,Care with residence,Small,2,30,8,22,5,4,1
2023,1,Asir Region,Care with residence,Small,5,79,12,67,26,14,12
2023,1,Asir Region,Care with residence,Micro,1,0,0,0,1,1,0
2023,1,Asir Region,Care with residence,Medium,2,115,2,113,8,0,8
2023,1,Makkah Region,Care with residence,Small,20,412,87,325,143,101,42
2023,1,Makkah Region,Care with residence,Micro,14,24,3,21,12,7,5
2023,1,Makkah Region,Care with residence,Medium,4,216,7,209,71,35,36
2023,1,Najran Region,Care with residence,Small,1,17,9,8,6,2,4
2023,1,Eastern Region,Forestry and logging,Micro,4,3,3,0,11,11,0
2023,1,Al-Jawf Region,Forestry and logging,Micro,1,0,0,0,2,2,0
2023,1,Riyadh Region,Forestry and logging,Small,1,4,1,3,27,27,0
2023,1,Riyadh Region,Forestry and logging,Micro,7,2,0,2,16,16,0
2023,1,Medina Region,Forestry and logging,Micro,2,1,0,1,3,3,0
2023,1,Jazan Region,Forestry and logging,Micro,1,1,0,1,0,0,0
2023,1,Hail Region,Forestry and logging,Micro,1,0,0,0,2,2,0
2023,1,Makkah Region,Forestry and logging,Micro,3,2,1,1,10,10,0
2023,1,Eastern Region,Education,Small,304,3867,1013,2854,2237,1963,274
2023,1,Eastern Region,Education,Large,14,4359,1931,2428,1222,1057,165
2023,1,Eastern Region,Education,Micro,371,388,153,235,490,442,48
2023,1,Eastern Region,Education,Medium,95,5702,1795,3907,4338,3576,762
2023,1,Al Bahah Region,Education,Small,12,128,55,73,109,85,24
2023,1,Al Bahah Region,Education,Micro,15,13,3,10,23,20,3
2023,1,Al-Jawf Region,Education,Small,35,534,226,308,275,248,27
2023,1,Al-Jawf Region,Education,Micro,51,39,21,18,85,82,3
2023,1,Al-Jawf Region,Education,Medium,8,416,164,252,301,273,28
2023,1,Northern border Region,Education,Small,18,200,142,58,147,141,6
2023,1,Northern border Region,Education,Micro,23,24,5,19,32,32,0
2023,1,Northern border Region,Education,Medium,3,212,67,145,90,70,20
2023,1,Riyadh Region,Education,Small,674,6515,1557,4958,5024,4189,835
2023,1,Riyadh Region,Education,Large,48,17261,8117,9144,10351,8451,1900
2023,1,Riyadh Region,Education,Micro,5750,1083,404,679,13456,13242,214
2023,1,Riyadh Region,Education,Medium,206,12921,3828,9093,9637,8058,1579
2023,1,Qassim Region,Education,Small,69,1045,271,774,354,314,40
2023,1,Qassim Region,Education,Large,2,365,127,238,309,213,96
2023,1,Qassim Region,Education,Micro,131,51,21,30,264,250,14
2023,1,Qassim Region,Education,Medium,17,912,427,485,642,472,170
2023,1,Medina Region,Education,Small,125,1644,319,1325,706,598,108
2023,1,Medina Region,Education,Large,3,616,279,337,248,181,67
2023,1,Medina Region,Education,Micro,146,139,38,101,203,189,14
2023,1,Medina Region,Education,Medium,35,2042,593,1449,1208,937,271
2023,1,Tabuk Region,Education,Small,57,794,258,536,475,423,52
2023,1,Tabuk Region,Education,Micro,37,32,6,26,43,41,2
2023,1,Tabuk Region,Education,Medium,19,1161,493,668,717,665,52
2023,1,Jazan Region,Education,Small,56,382,100,282,320,284,36
2023,1,Jazan Region,Education,Micro,91,71,10,61,139,131,8
2023,1,Jazan Region,Education,Medium,6,274,122,152,171,109,62
2023,1,Hail Region,Education,Small,35,359,77,282,142,125,17
2023,1,Hail Region,Education,Micro,114,40,12,28,264,262,2
2023,1,Hail Region,Education,Medium,6,400,212,188,238,232,6
2023,1,Asir Region,Education,Small,80,1082,237,845,458,385,73
2023,1,Asir Region,Education,Micro,109,89,29,60,169,161,8
2023,1,Asir Region,Education,Medium,20,916,534,382,686,624,62
2023,1,Makkah Region,Education,Small,402,5210,1060,4150,2556,1934,622
2023,1,Makkah Region,Education,Large,17,4408,1873,2535,2221,1387,834
2023,1,Makkah Region,Education,Micro,615,469,130,339,962,846,116
2023,1,Makkah Region,Education,Medium,146,8685,3487,5198,6678,5292,1386
2023,1,Najran Region,Education,Small,21,275,53,222,135,127,8
2023,1,Najran Region,Education,Micro,94,26,9,17,199,197,2
2023,1,Najran Region,Education,Medium,5,333,179,154,127,124,3
2023,1,Eastern Region,Storage and transportation support activities,Small,346,1703,1204,499,3613,3600,13
2023,1,Eastern Region,Storage and transportation support activities,Large,13,3883,3251,632,6135,6082,53
2023,1,Eastern Region,Storage and transportation support activities,Micro,733,515,388,127,1278,1274,4
2023,1,Eastern Region,Storage and transportation support activities,Medium,58,2039,1539,500,2916,2903,13
2023,1,Al Bahah Region,Storage and transportation support activities,Small,5,10,2,8,25,25,0
2023,1,Al Bahah Region,Storage and transportation support activities,Micro,22,6,5,1,36,36,0
2023,1,Al-Jawf Region,Storage and transportation support activities,Small,25,84,71,13,230,229,1
2023,1,Al-Jawf Region,Storage and transportation support activities,Micro,96,33,30,3,163,163,0
2023,1,Northern border Region,Storage and transportation support activities,Small,3,7,6,1,15,15,0
2023,1,Northern border Region,Storage and transportation support activities,Micro,33,10,5,5,57,57,0
2023,1,Northern border Region,Storage and transportation support activities,Medium,1,25,25,0,48,48,0
2023,1,Riyadh Region,Storage and transportation support activities,Small,527,2513,1281,1232,6488,6429,59
2023,1,Riyadh Region,Storage and transportation support activities,Large,26,10193,7618,2575,8543,8452,91
2023,1,Riyadh Region,Storage and transportation support activities,Micro,1803,655,362,293,4118,4093,25
2023,1,Riyadh Region,Storage and transportation support activities,Medium,122,3551,2032,1519,8975,8908,67
2023,1,Qassim Region,Storage and transportation support activities,Small,34,105,67,38,390,390,0
2023,1,Qassim Region,Storage and transportation support activities,Large,1,26,23,3,237,237,0
2023,1,Qassim Region,Storage and transportation support activities,Micro,149,35,23,12,328,325,3
2023,1,Qassim Region,Storage and transportation support activities,Medium,7,131,87,44,660,658,2
2023,1,Medina Region,Storage and transportation support activities,Small,42,211,139,72,479,478,1
2023,1,Medina Region,Storage and transportation support activities,Large,2,992,896,96,329,328,1
2023,1,Medina Region,Storage and transportation support activities,Micro,215,63,41,22,410,409,1
2023,1,Medina Region,Storage and transportation support activities,Medium,6,248,226,22,252,252,0
2023,1,Tabuk Region,Storage and transportation support activities,Small,22,80,51,29,235,234,1
2023,1,Tabuk Region,Storage and transportation support activities,Large,1,57,10,47,204,204,0
2023,1,Tabuk Region,Storage and transportation support activities,Micro,88,35,24,11,182,180,2
2023,1,Tabuk Region,Storage and transportation support activities,Medium,1,29,29,0,44,44,0
2023,1,Jazan Region,Storage and transportation support activities,Small,19,95,79,16,176,173,3
2023,1,Jazan Region,Storage and transportation support activities,Micro,82,19,16,3,191,191,0
2023,1,Jazan Region,Storage and transportation support activities,Medium,2,37,15,22,141,141,0
2023,1,Hail Region,Storage and transportation support activities,Small,10,11,5,6,72,72,0
2023,1,Hail Region,Storage and transportation support activities,Micro,68,16,11,5,161,161,0
2023,1,Asir Region,Storage and transportation support activities,Small,40,161,109,52,505,504,1
2023,1,Asir Region,Storage and transportation support activities,Large,1,69,42,27,304,304,0
2023,1,Asir Region,Storage and transportation support activities,Micro,131,43,26,17,283,283,0
2023,1,Asir Region,Storage and transportation support activities,Medium,3,56,55,1,166,166,0
2023,1,Makkah Region,Storage and transportation support activities,Small,459,2126,1355,771,5200,5152,48
2023,1,Makkah Region,Storage and transportation support activities,Large,21,5970,4987,983,9212,9194,18
2023,1,Makkah Region,Storage and transportation support activities,Micro,986,576,352,224,1837,1801,36
2023,1,Makkah Region,Storage and transportation support activities,Medium,95,3604,2638,966,6663,6611,52
2023,1,Najran Region,Storage and transportation support activities,Small,48,52,23,29,468,467,1
2023,1,Najran Region,Storage and transportation support activities,Micro,505,47,23,24,1328,1324,4
2023,1,Eastern Region,Research and development in the scientific field,Small,6,56,40,16,27,25,2
2023,1,Eastern Region,Research and development in the scientific field,Micro,18,23,11,12,25,25,0
2023,1,Eastern Region,Research and development in the scientific field,Medium,2,133,79,54,137,131,6
2023,1,Northern border Region,Research and development in the scientific field,Micro,1,1,1,0,0,0,0
2023,1,Riyadh Region,Research and development in the scientific field,Small,34,274,142,132,198,168,30
2023,1,Riyadh Region,Research and development in the scientific field,Micro,78,76,46,30,94,84,10
2023,1,Riyadh Region,Research and development in the scientific field,Medium,4,195,106,89,165,155,10
2023,1,Qassim Region,Research and development in the scientific field,Micro,2,0,0,0,4,4,0
2023,1,Medina Region,Research and development in the scientific field,Small,1,5,4,1,3,3,0
2023,1,Medina Region,Research and development in the scientific field,Micro,10,8,5,3,14,12,2
2023,1,Tabuk Region,Research and development in the scientific field,Micro,1,0,0,0,1,1,0
2023,1,Jazan Region,Research and development in the scientific field,Small,1,12,7,5,1,1,0
2023,1,Jazan Region,Research and development in the scientific field,Micro,1,0,0,0,1,1,0
2023,1,Hail Region,Research and development in the scientific field,Micro,1,4,0,4,0,0,0
2023,1,Asir Region,Research and development in the scientific field,Small,3,24,3,21,5,5,0
2023,1,Asir Region,Research and development in the scientific field,Micro,2,2,0,2,3,2,1
2023,1,Makkah Region,Research and development in the scientific field,Small,12,77,44,33,94,88,6
2023,1,Makkah Region,Research and development in the scientific field,Large,1,1071,1064,7,49,49,0
2023,1,Makkah Region,Research and development in the scientific field,Micro,43,42,15,27,66,60,6
2023,1,Makkah Region,Research and development in the scientific field,Medium,2,110,105,5,117,117,0
2023,1,Eastern Region,Non-privileged activities of production of goods and services carried out by private households for their own use,Small,1,0,0,0,12,12,0
2023,1,Eastern Region,Non-privileged activities of production of goods and services carried out by private households for their own use,Micro,2,0,0,0,2,2,0
2023,1,Riyadh Region,Non-privileged activities of production of goods and services carried out by private households for their own use,Small,1,0,0,0,6,6,0
2023,1,Qassim Region,Non-privileged activities of production of goods and services carried out by private households for their own use,Micro,1,0,0,0,1,1,0
2023,1,Makkah Region,Non-privileged activities of production of goods and services carried out by private households for their own use,Micro,2,0,0,0,2,0,2
2023,1,Eastern Region,"Other professional, scientific and technical activities",Small,34,201,91,110,255,224,31
2023,1,Eastern Region,"Other professional, scientific and technical activities",Large,1,229,193,36,317,315,2
2023,1,Eastern Region,"Other professional, scientific and technical activities",Micro,229,167,64,103,344,297,47
2023,1,Al Bahah Region,"Other professional, scientific and technical activities",Micro,15,4,3,1,33,29,4
2023,1,Al-Jawf Region,"Other professional, scientific and technical activities",Small,1,1,0,1,5,5,0
2023,1,Al-Jawf Region,"Other professional, scientific and technical activities",Micro,18,5,3,2,32,24,8
2023,1,Northern border Region,"Other professional, scientific and technical activities",Micro,13,6,0,6,24,21,3
2023,1,Riyadh Region,"Other professional, scientific and technical activities",Small,143,850,359,491,1099,927,172
2023,1,Riyadh Region,"Other professional, scientific and technical activities",Large,2,297,215,82,372,368,4
2023,1,Riyadh Region,"Other professional, scientific and technical activities",Micro,587,362,129,233,995,863,132
2023,1,Riyadh Region,"Other professional, scientific and technical activities",Medium,8,567,304,263,350,329,21
2023,1,Qassim Region,"Other professional, scientific and technical activities",Small,9,65,49,16,68,67,1
2023,1,Qassim Region,"Other professional, scientific and technical activities",Micro,39,18,6,12,73,66,7
2023,1,Medina Region,"Other professional, scientific and technical activities",Small,10,31,20,11,59,42,17
2023,1,Medina Region,"Other professional, scientific and technical activities",Micro,113,39,19,20,195,173,22
2023,1,Tabuk Region,"Other professional, scientific and technical activities",Small,1,3,3,0,5,5,0
2023,1,Tabuk Region,"Other professional, scientific and technical activities",Micro,47,17,8,9,83,79,4
2023,1,Jazan Region,"Other professional, scientific and technical activities",Small,1,12,1,11,0,0,0
2023,1,Jazan Region,"Other professional, scientific and technical activities",Micro,48,15,6,9,80,77,3
2023,1,Hail Region,"Other professional, scientific and technical activities",Small,1,1,1,0,6,6,0
2023,1,Hail Region,"Other professional, scientific and technical activities",Micro,29,7,1,6,53,49,4
2023,1,Asir Region,"Other professional, scientific and technical activities",Small,6,39,20,19,35,35,0
2023,1,Asir Region,"Other professional, scientific and technical activities",Micro,58,22,3,19,110,101,9
2023,1,Asir Region,"Other professional, scientific and technical activities",Medium,1,20,19,1,58,58,0
2023,1,Makkah Region,"Other professional, scientific and technical activities",Small,73,349,177,172,594,542,52
2023,1,Makkah Region,"Other professional, scientific and technical activities",Micro,460,231,72,159,823,697,126
2023,1,Makkah Region,"Other professional, scientific and technical activities",Medium,4,147,123,24,121,121,0
2023,1,Najran Region,"Other professional, scientific and technical activities",Micro,31,1,0,1,69,65,4
2023,1,Eastern Region,Activities supporting financial services activities and insurance activities,Small,31,372,205,167,150,147,3
2023,1,Eastern Region,Activities supporting financial services activities and insurance activities,Large,1,254,98,156,111,106,5
2023,1,Eastern Region,Activities supporting financial services activities and insurance activities,Micro,40,57,40,17,45,42,3
2023,1,Eastern Region,Activities supporting financial services activities and insurance activities,Medium,5,345,182,163,87,79,8
2023,1,Al-Jawf Region,Activities supporting financial services activities and insurance activities,Micro,1,0,0,0,2,2,0
2023,1,Riyadh Region,Activities supporting financial services activities and insurance activities,Small,166,2200,1341,859,859,809,50
2023,1,Riyadh Region,Activities supporting financial services activities and insurance activities,Large,12,23961,19011,4950,1380,1357,23
2023,1,Riyadh Region,Activities supporting financial services activities and insurance activities,Micro,166,215,134,81,153,148,5
2023,1,Riyadh Region,Activities supporting financial services activities and insurance activities,Medium,37,3778,2529,1249,811,755,56
2023,1,Qassim Region,Activities supporting financial services activities and insurance activities,Small,1,15,10,5,4,4,0
2023,1,Qassim Region,Activities supporting financial services activities and insurance activities,Micro,5,4,1,3,9,9,0
2023,1,Medina Region,Activities supporting financial services activities and insurance activities,Small,5,35,28,7,4,4,0
2023,1,Medina Region,Activities supporting financial services activities and insurance activities,Micro,12,27,25,2,7,7,0
2023,1,Tabuk Region,Activities supporting financial services activities and insurance activities,Micro,3,4,3,1,4,4,0
2023,1,Jazan Region,Activities supporting financial services activities and insurance activities,Small,1,4,4,0,5,5,0
2023,1,Hail Region,Activities supporting financial services activities and insurance activities,Micro,1,0,0,0,1,1,0
2023,1,Asir Region,Activities supporting financial services activities and insurance activities,Micro,5,3,2,1,6,6,0
2023,1,Makkah Region,Activities supporting financial services activities and insurance activities,Small,53,633,384,249,307,297,10
2023,1,Makkah Region,Activities supporting financial services activities and insurance activities,Micro,73,102,72,30,90,88,2
2023,1,Makkah Region,Activities supporting financial services activities and insurance activities,Medium,11,760,494,266,243,233,10
2023,1,Najran Region,Activities supporting financial services activities and insurance activities,Small,1,20,19,1,9,9,0
2023,1,Najran Region,Activities supporting financial services activities and insurance activities,Micro,2,0,0,0,3,3,0
2023,1,Eastern Region,Legal and accounting activities,Small,126,868,534,334,541,529,12
2023,1,Eastern Region,Legal and accounting activities,Micro,301,440,269,171,281,272,9
2023,1,Eastern Region,Legal and accounting activities,Medium,9,443,265,178,294,288,6
2023,1,Al Bahah Region,Legal and accounting activities,Small,1,10,0,10,7,1,6
2023,1,Al Bahah Region,Legal and accounting activities,Micro,12,12,7,5,14,14,0
2023,1,Al-Jawf Region,Legal and accounting activities,Small,10,63,41,22,12,12,0
2023,1,Al-Jawf Region,Legal and accounting activities,Micro,31,38,21,17,25,25,0
2023,1,Northern border Region,Legal and accounting activities,Small,1,8,5,3,5,5,0
2023,1,Northern border Region,Legal and accounting activities,Micro,9,13,10,3,6,6,0
2023,1,Riyadh Region,Legal and accounting activities,Small,512,4025,2457,1568,2694,2573,121
2023,1,Riyadh Region,Legal and accounting activities,Large,3,758,421,337,795,741,54
2023,1,Riyadh Region,Legal and accounting activities,Micro,1591,1620,1032,588,2157,2115,42
2023,1,Riyadh Region,Legal and accounting activities,Medium,26,1158,664,494,1143,1084,59
2023,1,Qassim Region,Legal and accounting activities,Small,18,131,71,60,27,27,0
2023,1,Qassim Region,Legal and accounting activities,Micro,85,115,65,50,72,71,1
2023,1,Medina Region,Legal and accounting activities,Small,30,253,150,103,109,107,2
2023,1,Medina Region,Legal and accounting activities,Micro,93,122,78,44,83,78,5
2023,1,Tabuk Region,Legal and accounting activities,Small,7,64,33,31,6,6,0
2023,1,Tabuk Region,Legal and accounting activities,Micro,25,27,7,20,21,21,0
2023,1,Jazan Region,Legal and accounting activities,Small,7,69,45,24,19,19,0
2023,1,Jazan Region,Legal and accounting activities,Micro,39,44,28,16,50,48,2
2023,1,Hail Region,Legal and accounting activities,Small,4,30,29,1,15,15,0
2023,1,Hail Region,Legal and accounting activities,Micro,35,43,28,15,29,27,2
2023,1,Asir Region,Legal and accounting activities,Small,8,64,51,13,49,49,0
2023,1,Asir Region,Legal and accounting activities,Micro,79,91,66,25,80,80,0
2023,1,Asir Region,Legal and accounting activities,Medium,2,70,36,34,82,82,0
2023,1,Makkah Region,Legal and accounting activities,Small,309,2405,1529,876,1311,1243,68
2023,1,Makkah Region,Legal and accounting activities,Large,1,163,57,106,122,118,4
2023,1,Makkah Region,Legal and accounting activities,Micro,770,1064,658,406,718,672,46
2023,1,Makkah Region,Legal and accounting activities,Medium,13,929,552,377,803,776,27
2023,1,Najran Region,Legal and accounting activities,Small,3,15,9,6,20,20,0
2023,1,Najran Region,Legal and accounting activities,Micro,37,8,6,2,78,77,1
2023,1,Eastern Region,Real estate activities,Small,217,1289,759,530,1652,1630,22
2023,1,Eastern Region,Real estate activities,Large,2,156,56,100,607,607,0
2023,1,Eastern Region,Real estate activities,Micro,732,522,313,209,1070,1059,11
2023,1,Eastern Region,Real estate activities,Medium,18,1060,702,358,968,949,19
2023,1,Al Bahah Region,Real estate activities,Small,3,19,18,1,21,21,0
2023,1,Al Bahah Region,Real estate activities,Micro,30,13,7,6,56,56,0
2023,1,Al-Jawf Region,Real estate activities,Small,7,47,28,19,69,68,1
2023,1,Al-Jawf Region,Real estate activities,Micro,55,30,15,15,89,87,2
2023,1,Northern border Region,Real estate activities,Small,4,20,15,5,31,31,0
2023,1,Northern border Region,Real estate activities,Micro,39,11,6,5,72,70,2
2023,1,Riyadh Region,Real estate activities,Small,754,4871,2915,1956,6268,6130,138
2023,1,Riyadh Region,Real estate activities,Large,9,2998,2055,943,1947,1893,54
2023,1,Riyadh Region,Real estate activities,Micro,2286,1912,1150,762,3168,3118,50
2023,1,Riyadh Region,Real estate activities,Medium,61,3187,2268,919,2880,2819,61
2023,1,Qassim Region,Real estate activities,Small,28,184,113,71,210,209,1
2023,1,Qassim Region,Real estate activities,Large,1,51,30,21,214,214,0
2023,1,Qassim Region,Real estate activities,Micro,194,103,66,37,304,299,5
2023,1,Qassim Region,Real estate activities,Medium,6,196,96,100,574,574,0
2023,1,Medina Region,Real estate activities,Small,43,204,136,68,347,347,0
2023,1,Medina Region,Real estate activities,Micro,300,132,82,50,510,503,7
2023,1,Medina Region,Real estate activities,Medium,4,131,89,42,238,232,6
2023,1,Tabuk Region,Real estate activities,Small,10,53,39,14,111,110,1
2023,1,Tabuk Region,Real estate activities,Micro,132,51,33,18,211,211,0
2023,1,Jazan Region,Real estate activities,Small,15,32,13,19,149,148,1
2023,1,Jazan Region,Real estate activities,Micro,169,64,33,31,280,278,2
2023,1,Jazan Region,Real estate activities,Medium,1,24,12,12,30,30,0
2023,1,Hail Region,Real estate activities,Small,10,53,40,13,72,72,0
2023,1,Hail Region,Real estate activities,Micro,89,38,20,18,142,142,0
2023,1,Hail Region,Real estate activities,Medium,1,0,0,0,59,59,0
2023,1,Asir Region,Real estate activities,Small,35,126,87,39,241,241,0
2023,1,Asir Region,Real estate activities,Micro,295,128,73,55,467,463,4
2023,1,Asir Region,Real estate activities,Medium,4,73,41,32,252,251,1
2023,1,Makkah Region,Real estate activities,Small,457,2392,1373,1019,3922,3809,113
2023,1,Makkah Region,Real estate activities,Large,3,927,511,416,553,531,22
2023,1,Makkah Region,Real estate activities,Micro,1951,1174,683,491,3076,2998,78
2023,1,Makkah Region,Real estate activities,Medium,40,1518,1094,424,2331,2253,78
2023,1,Najran Region,Real estate activities,Small,7,31,16,15,63,63,0
2023,1,Najran Region,Real estate activities,Micro,66,9,6,3,118,117,1
2023,1,Eastern Region,"Sports activities, entertainment and leisure activities",Small,145,579,232,347,1221,1023,198
2023,1,Eastern Region,"Sports activities, entertainment and leisure activities",Micro,319,265,88,177,478,429,49
2023,1,Eastern Region,"Sports activities, entertainment and leisure activities",Medium,8,282,99,183,436,425,11
2023,1,Al Bahah Region,"Sports activities, entertainment and leisure activities",Small,2,7,4,3,11,11,0
2023,1,Al Bahah Region,"Sports activities, entertainment and leisure activities",Micro,30,23,11,12,57,50,7
2023,1,Al-Jawf Region,"Sports activities, entertainment and leisure activities",Small,10,45,24,21,60,60,0
2023,1,Al-Jawf Region,"Sports activities, entertainment and leisure activities",Micro,39,15,6,9,69,63,6
2023,1,Northern border Region,"Sports activities, entertainment and leisure activities",Small,9,29,10,19,69,56,13
2023,1,Northern border Region,"Sports activities, entertainment and leisure activities",Micro,47,17,8,9,97,88,9
2023,1,Riyadh Region,"Sports activities, entertainment and leisure activities",Small,278,1411,519,892,2613,2251,362
2023,1,Riyadh Region,"Sports activities, entertainment and leisure activities",Large,6,1438,867,571,1900,1532,368
2023,1,Riyadh Region,"Sports activities, entertainment and leisure activities",Micro,768,474,155,319,1359,1242,117
2023,1,Riyadh Region,"Sports activities, entertainment and leisure activities",Medium,29,1331,447,884,1516,1225,291
2023,1,Qassim Region,"Sports activities, entertainment and leisure activities",Small,49,233,103,130,361,329,32
2023,1,Qassim Region,"Sports activities, entertainment and leisure activities",Micro,75,67,30,37,103,89,14
2023,1,Qassim Region,"Sports activities, entertainment and leisure activities",Medium,1,60,12,48,155,155,0
2023,1,Medina Region,"Sports activities, entertainment and leisure activities",Small,37,181,59,122,268,247,21
2023,1,Medina Region,"Sports activities, entertainment and leisure activities",Micro,102,83,33,50,164,143,21
2023,1,Medina Region,"Sports activities, entertainment and leisure activities",Medium,2,85,37,48,124,113,11
2023,1,Tabuk Region,"Sports activities, entertainment and leisure activities",Small,25,101,33,68,150,130,20
2023,1,Tabuk Region,"Sports activities, entertainment and leisure activities",Micro,76,36,11,25,133,125,8
2023,1,Jazan Region,"Sports activities, entertainment and leisure activities",Small,12,35,9,26,177,161,16
2023,1,Jazan Region,"Sports activities, entertainment and leisure activities",Micro,69,43,14,29,102,88,14
2023,1,Jazan Region,"Sports activities, entertainment and leisure activities",Medium,3,33,18,15,195,195,0
2023,1,Hail Region,"Sports activities, entertainment and leisure activities",Small,23,85,35,50,203,201,2
2023,1,Hail Region,"Sports activities, entertainment and leisure activities",Micro,60,39,21,18,107,102,5
2023,1,Asir Region,"Sports activities, entertainment and leisure activities",Small,65,285,81,204,568,499,69
2023,1,Asir Region,"Sports activities, entertainment and leisure activities",Micro,145,88,35,53,249,236,13
2023,1,Makkah Region,"Sports activities, entertainment and leisure activities",Small,199,1023,384,639,1514,1293,221
2023,1,Makkah Region,"Sports activities, entertainment and leisure activities",Large,1,140,76,64,166,109,57
2023,1,Makkah Region,"Sports activities, entertainment and leisure activities",Micro,605,383,154,229,1064,966,98
2023,1,Makkah Region,"Sports activities, entertainment and leisure activities",Medium,25,1257,490,767,1272,1147,125
2023,1,Najran Region,"Sports activities, entertainment and leisure activities",Small,16,68,38,30,117,113,4
2023,1,Najran Region,"Sports activities, entertainment and leisure activities",Micro,41,22,13,9,87,81,6
2023,1,Eastern Region,Veterinary activities,Small,13,65,25,40,137,129,8
2023,1,Eastern Region,Veterinary activities,Micro,50,30,15,15,84,77,7
2023,1,Al Bahah Region,Veterinary activities,Micro,2,1,0,1,2,2,0
2023,1,Al-Jawf Region,Veterinary activities,Micro,1,0,0,0,3,3,0
2023,1,Northern border Region,Veterinary activities,Micro,5,3,2,1,10,10,0
2023,1,Riyadh Region,Veterinary activities,Small,35,161,65,96,324,283,41
2023,1,Riyadh Region,Veterinary activities,Micro,83,50,17,33,144,138,6
2023,1,Riyadh Region,Veterinary activities,Medium,3,89,40,49,124,115,9
2023,1,Qassim Region,Veterinary activities,Small,3,11,9,2,10,10,0
2023,1,Qassim Region,Veterinary activities,Micro,19,5,2,3,33,31,2
2023,1,Qassim Region,Veterinary activities,Medium,1,31,31,0,55,55,0
2023,1,Medina Region,Veterinary activities,Small,4,15,4,11,22,17,5
2023,1,Medina Region,Veterinary activities,Micro,17,2,1,1,31,30,1
2023,1,Tabuk Region,Veterinary activities,Small,2,7,1,6,17,16,1
2023,1,Tabuk Region,Veterinary activities,Micro,8,7,6,1,14,14,0
2023,1,Jazan Region,Veterinary activities,Micro,7,4,2,2,14,14,0
2023,1,Hail Region,Veterinary activities,Small,1,1,0,1,6,6,0
2023,1,Hail Region,Veterinary activities,Micro,7,0,0,0,14,13,1
2023,1,Asir Region,Veterinary activities,Small,3,7,5,2,27,24,3
2023,1,Asir Region,Veterinary activities,Micro,33,6,2,4,54,53,1
2023,1,Makkah Region,Veterinary activities,Small,20,98,23,75,181,156,25
2023,1,Makkah Region,Veterinary activities,Micro,56,23,8,15,101,96,5
2023,1,Makkah Region,Veterinary activities,Medium,1,19,6,13,45,38,7
2023,1,Najran Region,Veterinary activities,Micro,11,2,1,1,17,17,0
2023,1,Eastern Region,Rental activities,Small,321,1097,704,393,3557,3545,12
2023,1,Eastern Region,Rental activities,Large,10,1204,794,410,2867,2864,3
2023,1,Eastern Region,Rental activities,Micro,1964,424,226,198,4123,4108,15
2023,1,Eastern Region,Rental activities,Medium,39,890,651,239,2935,2929,6
2023,1,Al Bahah Region,Rental activities,Small,7,6,2,4,47,47,0
2023,1,Al Bahah Region,Rental activities,Micro,144,15,13,2,280,278,2
2023,1,Al-Jawf Region,Rental activities,Small,25,22,18,4,204,204,0
2023,1,Al-Jawf Region,Rental activities,Micro,603,38,23,15,1205,1194,11
2023,1,Northern border Region,Rental activities,Small,9,32,23,9,92,92,0
2023,1,Northern border Region,Rental activities,Micro,199,20,18,2,415,411,4
2023,1,Riyadh Region,Rental activities,Small,1012,1460,829,631,7985,7930,55
2023,1,Riyadh Region,Rental activities,Large,6,1615,1339,276,2482,2479,3
2023,1,Riyadh Region,Rental activities,Micro,48937,2682,1289,1393,124732,124158,574
2023,1,Riyadh Region,Rental activities,Medium,40,1655,1178,477,2856,2846,10
2023,1,Qassim Region,Rental activities,Small,65,142,97,45,511,510,1
2023,1,Qassim Region,Rental activities,Large,1,73,62,11,278,278,0
2023,1,Qassim Region,Rental activities,Micro,1141,154,97,57,2612,2591,21
2023,1,Qassim Region,Rental activities,Medium,4,158,124,34,473,473,0
2023,1,Medina Region,Rental activities,Small,76,264,174,90,772,771,1
2023,1,Medina Region,Rental activities,Micro,986,133,80,53,2016,2004,12
2023,1,Medina Region,Rental activities,Medium,4,151,144,7,381,381,0
2023,1,Tabuk Region,Rental activities,Small,17,75,66,9,155,155,0
2023,1,Tabuk Region,Rental activities,Micro,424,52,26,26,776,773,3
2023,1,Tabuk Region,Rental activities,Medium,4,74,57,17,206,206,0
2023,1,Jazan Region,Rental activities,Small,22,45,34,11,235,226,9
2023,1,Jazan Region,Rental activities,Micro,1130,73,40,33,2560,2552,8
2023,1,Jazan Region,Rental activities,Medium,1,37,37,0,28,28,0
2023,1,Hail Region,Rental activities,Small,43,42,30,12,304,302,2
2023,1,Hail Region,Rental activities,Micro,905,59,26,33,2339,2322,17
2023,1,Hail Region,Rental activities,Medium,1,0,0,0,69,69,0
2023,1,Asir Region,Rental activities,Small,64,176,117,59,506,502,4
2023,1,Asir Region,Rental activities,Micro,1394,148,84,64,2774,2767,7
2023,1,Asir Region,Rental activities,Medium,1,59,59,0,61,60,1
2023,1,Makkah Region,Rental activities,Small,219,858,589,269,2121,2099,22
2023,1,Makkah Region,Rental activities,Large,5,596,398,198,1502,1500,2
2023,1,Makkah Region,Rental activities,Micro,3187,417,235,182,6850,6759,91
2023,1,Makkah Region,Rental activities,Medium,23,756,633,123,1265,1263,2
2023,1,Najran Region,Rental activities,Small,40,40,23,17,347,347,0
2023,1,Najran Region,Rental activities,Micro,1234,62,31,31,2987,2971,16
2023,1,Eastern Region,"Office administrative activities, office support activities and other business support activities",Small,136,766,367,399,1077,1049,28
2023,1,Eastern Region,"Office administrative activities, office support activities and other business support activities",Large,2,659,501,158,803,803,0
2023,1,Eastern Region,"Office administrative activities, office support activities and other business support activities",Micro,788,416,186,230,1353,1320,33
2023,1,Eastern Region,"Office administrative activities, office support activities and other business support activities",Medium,14,707,512,195,963,948,15
2023,1,Al Bahah Region,"Office administrative activities, office support activities and other business support activities",Small,6,21,20,1,32,32,0
2023,1,Al Bahah Region,"Office administrative activities, office support activities and other business support activities",Micro,43,16,10,6,75,75,0
2023,1,Al-Jawf Region,"Office administrative activities, office support activities and other business support activities",Small,5,9,4,5,35,35,0
2023,1,Al-Jawf Region,"Office administrative activities, office support activities and other business support activities",Micro,88,22,12,10,175,171,4
2023,1,Northern border Region,"Office administrative activities, office support activities and other business support activities",Small,3,5,0,5,18,18,0
2023,1,Northern border Region,"Office administrative activities, office support activities and other business support activities",Micro,50,9,5,4,99,99,0
2023,1,Riyadh Region,"Office administrative activities, office support activities and other business support activities",Small,542,3306,1403,1903,4338,4040,298
2023,1,Riyadh Region,"Office administrative activities, office support activities and other business support activities",Large,12,4894,2658,2236,3012,2739,273
2023,1,Riyadh Region,"Office administrative activities, office support activities and other business support activities",Micro,2317,1300,606,694,3941,3799,142
2023,1,Riyadh Region,"Office administrative activities, office support activities and other business support activities",Medium,47,2182,1003,1179,2178,2014,164
2023,1,Qassim Region,"Office administrative activities, office support activities and other business support activities",Small,18,70,37,33,237,237,0
2023,1,Qassim Region,"Office administrative activities, office support activities and other business support activities",Micro,238,78,48,30,403,402,1
2023,1,Qassim Region,"Office administrative activities, office support activities and other business support activities",Medium,1,0,0,0,55,54,1
2023,1,Medina Region,"Office administrative activities, office support activities and other business support activities",Small,33,171,105,66,250,244,6
2023,1,Medina Region,"Office administrative activities, office support activities and other business support activities",Micro,318,108,56,52,571,541,30
2023,1,Medina Region,"Office administrative activities, office support activities and other business support activities",Medium,1,70,47,23,116,98,18
2023,1,Tabuk Region,"Office administrative activities, office support activities and other business support activities",Small,10,46,25,21,73,63,10
2023,1,Tabuk Region,"Office administrative activities, office support activities and other business support activities",Micro,156,41,12,29,262,259,3
2023,1,Tabuk Region,"Office administrative activities, office support activities and other business support activities",Medium,1,26,15,11,33,27,6
2023,1,Jazan Region,"Office administrative activities, office support activities and other business support activities",Small,5,17,9,8,34,34,0
2023,1,Jazan Region,"Office administrative activities, office support activities and other business support activities",Micro,138,34,13,21,269,265,4
2023,1,Hail Region,"Office administrative activities, office support activities and other business support activities",Small,5,24,9,15,44,44,0
2023,1,Hail Region,"Office administrative activities, office support activities and other business support activities",Micro,186,38,15,23,337,329,8
2023,1,Asir Region,"Office administrative activities, office support activities and other business support activities",Small,20,57,32,25,125,123,2
2023,1,Asir Region,"Office administrative activities, office support activities and other business support activities",Micro,305,85,47,38,545,543,2
2023,1,Asir Region,"Office administrative activities, office support activities and other business support activities",Medium,1,25,18,7,30,30,0
2023,1,Makkah Region,"Office administrative activities, office support activities and other business support activities",Small,293,1485,692,793,2329,2172,157
2023,1,Makkah Region,"Office administrative activities, office support activities and other business support activities",Large,5,3053,1928,1125,1138,1078,60
2023,1,Makkah Region,"Office administrative activities, office support activities and other business support activities",Micro,1546,666,312,354,2803,2660,143
2023,1,Makkah Region,"Office administrative activities, office support activities and other business support activities",Medium,27,1164,702,462,1314,1256,58
2023,1,Najran Region,"Office administrative activities, office support activities and other business support activities",Small,3,6,3,3,13,13,0
2023,1,Najran Region,"Office administrative activities, office support activities and other business support activities",Micro,104,25,11,14,185,185,0
2023,1,Eastern Region,Other mining and quarrying activities,Small,56,188,105,83,829,828,1
2023,1,Eastern Region,Other mining and quarrying activities,Large,3,1030,946,84,2199,2199,0
2023,1,Eastern Region,Other mining and quarrying activities,Micro,96,71,46,25,172,171,1
2023,1,Eastern Region,Other mining and quarrying activities,Medium,11,346,224,122,683,680,3
2023,1,Al Bahah Region,Other mining and quarrying activities,Small,3,11,2,9,39,39,0
2023,1,Al Bahah Region,Other mining and quarrying activities,Micro,7,6,4,2,12,12,0
2023,1,Al-Jawf Region,Other mining and quarrying activities,Small,2,12,9,3,55,55,0
2023,1,Al-Jawf Region,Other mining and quarrying activities,Micro,12,8,7,1,21,21,0
2023,1,Northern border Region,Other mining and quarrying activities,Small,3,7,5,2,19,19,0
2023,1,Northern border Region,Other mining and quarrying activities,Micro,7,3,2,1,22,22,0
2023,1,Northern border Region,Other mining and quarrying activities,Medium,2,125,115,10,119,119,0
2023,1,Riyadh Region,Other mining and quarrying activities,Small,151,553,303,250,1898,1893,5
2023,1,Riyadh Region,Other mining and quarrying activities,Large,6,380,292,88,1822,1822,0
2023,1,Riyadh Region,Other mining and quarrying activities,Micro,295,196,114,82,539,536,3
2023,1,Riyadh Region,Other mining and quarrying activities,Medium,28,746,390,356,1834,1831,3
2023,1,Qassim Region,Other mining and quarrying activities,Small,9,53,37,16,109,109,0
2023,1,Qassim Region,Other mining and quarrying activities,Micro,29,15,15,0,52,52,0
2023,1,Qassim Region,Other mining and quarrying activities,Medium,3,49,22,27,252,252,0
2023,1,Medina Region,Other mining and quarrying activities,Small,28,129,91,38,411,411,0
2023,1,Medina Region,Other mining and quarrying activities,Large,3,351,313,38,649,647,2
2023,1,Medina Region,Other mining and quarrying activities,Micro,53,38,24,14,92,92,0
2023,1,Medina Region,Other mining and quarrying activities,Medium,1,23,23,0,48,48,0
2023,1,Tabuk Region,Other mining and quarrying activities,Small,8,38,22,16,70,70,0
2023,1,Tabuk Region,Other mining and quarrying activities,Micro,14,8,3,5,17,17,0
2023,1,Tabuk Region,Other mining and quarrying activities,Medium,1,14,8,6,85,85,0
2023,1,Jazan Region,Other mining and quarrying activities,Small,19,73,42,31,254,254,0
2023,1,Jazan Region,Other mining and quarrying activities,Micro,29,19,7,12,48,47,1
2023,1,Jazan Region,Other mining and quarrying activities,Medium,1,32,10,22,70,70,0
2023,1,Hail Region,Other mining and quarrying activities,Small,1,1,0,1,9,9,0
2023,1,Hail Region,Other mining and quarrying activities,Micro,11,3,1,2,14,14,0
2023,1,Asir Region,Other mining and quarrying activities,Small,22,69,45,24,243,243,0
2023,1,Asir Region,Other mining and quarrying activities,Micro,61,34,24,10,115,113,2
2023,1,Asir Region,Other mining and quarrying activities,Medium,2,27,23,4,124,124,0
2023,1,Makkah Region,Other mining and quarrying activities,Small,74,256,131,125,831,828,3
2023,1,Makkah Region,Other mining and quarrying activities,Large,1,163,148,15,110,110,0
2023,1,Makkah Region,Other mining and quarrying activities,Micro,140,90,49,41,245,244,1
2023,1,Makkah Region,Other mining and quarrying activities,Medium,10,275,204,71,784,783,1
2023,1,Najran Region,Other mining and quarrying activities,Small,8,26,16,10,133,133,0
2023,1,Najran Region,Other mining and quarrying activities,Micro,15,7,4,3,33,32,1
2023,1,Eastern Region,"Creative activities, arts and entertainment activities",Small,2,9,5,4,17,17,0
2023,1,Eastern Region,"Creative activities, arts and entertainment activities",Micro,30,21,6,15,43,38,5
2023,1,Al Bahah Region,"Creative activities, arts and entertainment activities",Micro,2,2,0,2,4,4,0
2023,1,Northern border Region,"Creative activities, arts and entertainment activities",Micro,1,0,0,0,2,2,0
2023,1,Riyadh Region,"Creative activities, arts and entertainment activities",Small,13,75,28,47,87,74,13
2023,1,Riyadh Region,"Creative activities, arts and entertainment activities",Large,2,231,171,60,319,316,3
2023,1,Riyadh Region,"Creative activities, arts and entertainment activities",Micro,100,61,31,30,144,127,17
2023,1,Riyadh Region,"Creative activities, arts and entertainment activities",Medium,2,56,27,29,166,164,2
2023,1,Qassim Region,"Creative activities, arts and entertainment activities",Micro,6,4,2,2,12,12,0
2023,1,Medina Region,"Creative activities, arts and entertainment activities",Small,1,1,0,1,6,6,0
2023,1,Medina Region,"Creative activities, arts and entertainment activities",Micro,13,3,2,1,21,19,2
2023,1,Tabuk Region,"Creative activities, arts and entertainment activities",Micro,3,0,0,0,6,6,0
2023,1,Jazan Region,"Creative activities, arts and entertainment activities",Micro,2,1,1,0,3,2,1
2023,1,Hail Region,"Creative activities, arts and entertainment activities",Micro,2,1,1,0,2,2,0
2023,1,Asir Region,"Creative activities, arts and entertainment activities",Small,2,3,3,0,10,10,0
2023,1,Asir Region,"Creative activities, arts and entertainment activities",Micro,12,1,1,0,26,26,0
2023,1,Asir Region,"Creative activities, arts and entertainment activities",Medium,1,24,5,19,29,29,0
2023,1,Makkah Region,"Creative activities, arts and entertainment activities",Small,6,26,8,18,49,47,2
2023,1,Makkah Region,"Creative activities, arts and entertainment activities",Micro,104,71,27,44,155,135,20
2023,1,Najran Region,"Creative activities, arts and entertainment activities",Micro,2,0,0,0,5,5,0
2023,1,Eastern Region,Residence,Small,270,1327,711,616,2507,2486,21
2023,1,Eastern Region,Residence,Large,1,95,68,27,168,168,0
2023,1,Eastern Region,Residence,Micro,324,268,137,131,595,583,12
2023,1,Eastern Region,Residence,Medium,35,1285,722,563,1961,1886,75
2023,1,Al Bahah Region,Residence,Small,21,79,50,29,169,169,0
2023,1,Al Bahah Region,Residence,Micro,79,47,33,14,129,128,1
2023,1,Al Bahah Region,Residence,Medium,1,25,13,12,41,41,0
2023,1,Al-Jawf Region,Residence,Small,9,33,16,17,88,88,0
2023,1,Al-Jawf Region,Residence,Micro,64,40,21,19,114,113,1
2023,1,Northern border Region,Residence,Small,12,49,23,26,101,101,0
2023,1,Northern border Region,Residence,Micro,36,18,14,4,77,77,0
2023,1,Northern border Region,Residence,Medium,1,18,9,9,38,38,0
2023,1,Riyadh Region,Residence,Small,413,2146,1133,1013,4157,4098,59
2023,1,Riyadh Region,Residence,Large,7,1151,773,378,1562,1472,90
2023,1,Riyadh Region,Residence,Micro,746,517,249,268,1478,1456,22
2023,1,Riyadh Region,Residence,Medium,80,2996,1773,1223,4394,4309,85
2023,1,Qassim Region,Residence,Small,52,226,143,83,417,417,0
2023,1,Qassim Region,Residence,Large,1,0,0,0,319,314,5
2023,1,Qassim Region,Residence,Micro,109,79,54,25,224,224,0
2023,1,Qassim Region,Residence,Medium,4,107,71,36,169,169,0
2023,1,Medina Region,Residence,Small,206,1222,830,392,1757,1740,17
2023,1,Medina Region,Residence,Large,4,580,387,193,777,769,8
2023,1,Medina Region,Residence,Micro,397,256,180,76,698,682,16
2023,1,Medina Region,Residence,Medium,39,1610,1118,492,2070,2043,27
2023,1,Tabuk Region,Residence,Small,41,217,116,101,360,360,0
2023,1,Tabuk Region,Residence,Micro,104,77,41,36,196,194,2
2023,1,Tabuk Region,Residence,Medium,5,191,106,85,334,319,15
2023,1,Jazan Region,Residence,Small,50,201,99,102,414,384,30
2023,1,Jazan Region,Residence,Micro,263,123,49,74,449,447,2
2023,1,Jazan Region,Residence,Medium,5,134,59,75,343,339,4
2023,1,Hail Region,Residence,Small,24,90,67,23,176,175,1
2023,1,Hail Region,Residence,Micro,67,47,28,19,130,130,0
2023,1,Hail Region,Residence,Medium,1,19,14,5,44,44,0
2023,1,Asir Region,Residence,Small,118,413,209,204,829,824,5
2023,1,Asir Region,Residence,Micro,407,267,145,122,794,782,12
2023,1,Asir Region,Residence,Medium,5,145,86,59,268,265,3
2023,1,Makkah Region,Residence,Small,619,2945,1791,1154,5346,5216,130
2023,1,Makkah Region,Residence,Large,15,2180,1511,669,2850,2817,33
2023,1,Makkah Region,Residence,Micro,1202,842,528,314,2125,2077,48
2023,1,Makkah Region,Residence,Medium,87,3781,2423,1358,5093,4911,182
2023,1,Najran Region,Residence,Small,21,79,34,45,172,170,2
2023,1,Najran Region,Residence,Micro,106,43,23,20,236,234,2
2023,1,Najran Region,Residence,Medium,1,25,9,16,34,32,2
2023,1,Eastern Region,Public administration and defence; and compulsory social security,Small,17,237,172,65,137,133,4
2023,1,Eastern Region,Public administration and defence; and compulsory social security,Large,2,801,639,162,220,216,4
2023,1,Eastern Region,Public administration and defence; and compulsory social security,Micro,82,47,26,21,115,115,0
2023,1,Eastern Region,Public administration and defence; and compulsory social security,Medium,1,30,29,1,34,34,0
2023,1,Al Bahah Region,Public administration and defence; and compulsory social security,Small,1,8,4,4,1,1,0
2023,1,Al Bahah Region,Public administration and defence; and compulsory social security,Micro,8,0,0,0,21,21,0
2023,1,Al-Jawf Region,Public administration and defence; and compulsory social security,Micro,7,1,0,1,16,15,1
2023,1,Northern border Region,Public administration and defence; and compulsory social security,Micro,3,0,0,0,10,10,0
2023,1,Riyadh Region,Public administration and defence; and compulsory social security,Small,42,339,168,171,374,337,37
2023,1,Riyadh Region,Public administration and defence; and compulsory social security,Large,2,1222,793,429,187,176,11
2023,1,Riyadh Region,Public administration and defence; and compulsory social security,Micro,197,93,49,44,318,308,10
2023,1,Riyadh Region,Public administration and defence; and compulsory social security,Medium,3,250,199,51,76,70,6
2023,1,Qassim Region,Public administration and defence; and compulsory social security,Small,4,63,23,40,36,32,4
2023,1,Qassim Region,Public administration and defence; and compulsory social security,Micro,23,5,5,0,53,51,2
2023,1,Medina Region,Public administration and defence; and compulsory social security,Small,2,18,15,3,7,7,0
2023,1,Medina Region,Public administration and defence; and compulsory social security,Micro,32,11,6,5,72,71,1
2023,1,Tabuk Region,Public administration and defence; and compulsory social security,Small,3,52,23,29,22,21,1
2023,1,Tabuk Region,Public administration and defence; and compulsory social security,Micro,13,0,0,0,33,32,1
2023,1,Jazan Region,Public administration and defence; and compulsory social security,Small,1,2,0,2,4,1,3
2023,1,Jazan Region,Public administration and defence; and compulsory social security,Micro,35,4,2,2,105,105,0
2023,1,Hail Region,Public administration and defence; and compulsory social security,Micro,10,7,5,2,16,16,0
2023,1,Asir Region,Public administration and defence; and compulsory social security,Small,2,5,2,3,12,12,0
2023,1,Asir Region,Public administration and defence; and compulsory social security,Micro,21,3,2,1,55,55,0
2023,1,Makkah Region,Public administration and defence; and compulsory social security,Small,34,199,115,84,234,226,8
2023,1,Makkah Region,Public administration and defence; and compulsory social security,Micro,207,84,55,29,343,334,9
2023,1,Makkah Region,Public administration and defence; and compulsory social security,Medium,2,330,174,156,92,88,4
2023,1,Najran Region,Public administration and defence; and compulsory social security,Micro,15,1,1,0,28,28,0
2023,1,Eastern Region,Telecommunications,Small,27,201,142,59,245,240,5
2023,1,Eastern Region,Telecommunications,Micro,98,61,35,26,157,155,2
2023,1,Eastern Region,Telecommunications,Medium,2,91,84,7,50,50,0
2023,1,Al Bahah Region,Telecommunications,Small,1,3,1,2,6,6,0
2023,1,Al Bahah Region,Telecommunications,Micro,3,3,3,0,3,3,0
2023,1,Al-Jawf Region,Telecommunications,Micro,15,7,3,4,22,22,0
2023,1,Northern border Region,Telecommunications,Micro,13,4,0,4,28,27,1
2023,1,Riyadh Region,Telecommunications,Small,128,863,386,477,1365,1300,65
2023,1,Riyadh Region,Telecommunications,Large,12,19729,15214,4515,2735,2679,56
2023,1,Riyadh Region,Telecommunications,Micro,348,190,106,84,641,633,8
2023,1,Riyadh Region,Telecommunications,Medium,30,2045,1330,715,1265,1229,36
2023,1,Qassim Region,Telecommunications,Small,5,28,10,18,51,51,0
2023,1,Qassim Region,Telecommunications,Micro,57,16,10,6,106,106,0
2023,1,Medina Region,Telecommunications,Small,3,16,5,11,6,6,0
2023,1,Medina Region,Telecommunications,Micro,31,11,8,3,57,57,0
2023,1,Tabuk Region,Telecommunications,Small,1,2,1,1,5,5,0
2023,1,Tabuk Region,Telecommunications,Micro,16,6,4,2,19,19,0
2023,1,Jazan Region,Telecommunications,Small,2,2,2,0,12,12,0
2023,1,Jazan Region,Telecommunications,Micro,21,4,3,1,36,36,0
2023,1,Hail Region,Telecommunications,Small,1,0,0,0,9,9,0
2023,1,Hail Region,Telecommunications,Micro,17,9,2,7,30,28,2
2023,1,Asir Region,Telecommunications,Small,3,6,4,2,14,14,0
2023,1,Asir Region,Telecommunications,Micro,43,17,12,5,68,67,1
2023,1,Makkah Region,Telecommunications,Small,31,235,102,133,292,282,10
2023,1,Makkah Region,Telecommunications,Micro,236,82,47,35,397,391,6
2023,1,Makkah Region,Telecommunications,Medium,1,73,71,2,29,29,0
2023,1,Najran Region,Telecommunications,Small,1,0,0,0,11,11,0
2023,1,Najran Region,Telecommunications,Micro,11,1,1,0,25,25,0
2023,1,Eastern Region,Repair and install machinery and equipment,Small,308,1159,787,372,3379,3372,7
2023,1,Eastern Region,Repair and install machinery and equipment,Large,18,3090,2456,634,7467,7452,15
2023,1,Eastern Region,Repair and install machinery and equipment,Micro,918,333,178,155,1997,1994,3
2023,1,Eastern Region,Repair and install machinery and equipment,Medium,70,2379,1709,670,4905,4899,6
2023,1,Al Bahah Region,Repair and install machinery and equipment,Small,2,2,1,1,14,14,0
2023,1,Al Bahah Region,Repair and install machinery and equipment,Micro,53,7,6,1,90,90,0
2023,1,Al-Jawf Region,Repair and install machinery and equipment,Small,7,12,8,4,41,41,0
2023,1,Al-Jawf Region,Repair and install machinery and equipment,Micro,70,9,6,3,156,154,2
2023,1,Northern border Region,Repair and install machinery and equipment,Small,1,0,0,0,7,7,0
2023,1,Northern border Region,Repair and install machinery and equipment,Micro,68,4,3,1,177,177,0
2023,1,Northern border Region,Repair and install machinery and equipment,Medium,2,54,50,4,175,175,0
2023,1,Riyadh Region,Repair and install machinery and equipment,Small,284,1156,671,485,3390,3369,21
2023,1,Riyadh Region,Repair and install machinery and equipment,Large,18,5905,5086,819,7137,7006,131
2023,1,Riyadh Region,Repair and install machinery and equipment,Micro,1207,296,152,144,2842,2824,18
2023,1,Riyadh Region,Repair and install machinery and equipment,Medium,80,2761,2036,725,5863,5763,100
2023,1,Qassim Region,Repair and install machinery and equipment,Small,39,95,46,49,425,424,1
2023,1,Qassim Region,Repair and install machinery and equipment,Micro,234,26,19,7,565,564,1
2023,1,Qassim Region,Repair and install machinery and equipment,Medium,5,104,93,11,418,418,0
2023,1,Medina Region,Repair and install machinery and equipment,Small,27,135,104,31,265,265,0
2023,1,Medina Region,Repair and install machinery and equipment,Micro,304,49,23,26,630,628,2
2023,1,Medina Region,Repair and install machinery and equipment,Medium,2,32,19,13,95,95,0
2023,1,Tabuk Region,Repair and install machinery and equipment,Small,5,13,9,4,29,29,0
2023,1,Tabuk Region,Repair and install machinery and equipment,Micro,136,15,9,6,301,299,2
2023,1,Tabuk Region,Repair and install machinery and equipment,Medium,1,34,34,0,21,21,0
2023,1,Jazan Region,Repair and install machinery and equipment,Small,7,13,5,8,60,60,0
2023,1,Jazan Region,Repair and install machinery and equipment,Micro,359,33,22,11,877,876,1
2023,1,Jazan Region,Repair and install machinery and equipment,Medium,1,26,6,20,135,135,0
2023,1,Hail Region,Repair and install machinery and equipment,Small,3,5,1,4,54,54,0
2023,1,Hail Region,Repair and install machinery and equipment,Micro,81,13,7,6,181,181,0
2023,1,Asir Region,Repair and install machinery and equipment,Small,14,29,20,9,131,131,0
2023,1,Asir Region,Repair and install machinery and equipment,Large,1,74,46,28,384,384,0
2023,1,Asir Region,Repair and install machinery and equipment,Micro,234,30,12,18,510,508,2
2023,1,Asir Region,Repair and install machinery and equipment,Medium,1,11,10,1,48,48,0
2023,1,Makkah Region,Repair and install machinery and equipment,Small,160,617,314,303,1830,1811,19
2023,1,Makkah Region,Repair and install machinery and equipment,Large,3,4194,3405,789,1620,1620,0
2023,1,Makkah Region,Repair and install machinery and equipment,Micro,1063,202,96,106,2466,2445,21
2023,1,Makkah Region,Repair and install machinery and equipment,Medium,32,1149,895,254,2476,2467,9
2023,1,Najran Region,Repair and install machinery and equipment,Small,2,7,4,3,29,29,0
2023,1,Najran Region,Repair and install machinery and equipment,Micro,59,10,6,4,155,155,0
2023,1,Najran Region,Repair and install machinery and equipment,Medium,1,21,13,8,51,50,1
2023,1,Eastern Region,"Repair of computers, personal and household goods",Small,94,159,99,60,895,875,20
2023,1,Eastern Region,"Repair of computers, personal and household goods",Large,3,88,6,82,893,893,0
2023,1,Eastern Region,"Repair of computers, personal and household goods",Micro,901,178,106,72,1930,1926,4
2023,1,Eastern Region,"Repair of computers, personal and household goods",Medium,13,374,305,69,1099,1099,0
2023,1,Al Bahah Region,"Repair of computers, personal and household goods",Small,2,1,1,0,12,12,0
2023,1,Al Bahah Region,"Repair of computers, personal and household goods",Micro,73,12,11,1,141,141,0
2023,1,Al-Jawf Region,"Repair of computers, personal and household goods",Small,9,6,4,2,103,103,0
2023,1,Al-Jawf Region,"Repair of computers, personal and household goods",Micro,150,14,9,5,333,333,0
2023,1,Northern border Region,"Repair of computers, personal and household goods",Small,1,1,1,0,5,5,0
2023,1,Northern border Region,"Repair of computers, personal and household goods",Micro,77,8,5,3,170,170,0
2023,1,Riyadh Region,"Repair of computers, personal and household goods",Small,336,365,205,160,5233,5212,21
2023,1,Riyadh Region,"Repair of computers, personal and household goods",Large,23,230,104,126,10935,10929,6
2023,1,Riyadh Region,"Repair of computers, personal and household goods",Micro,1878,242,137,105,4149,4128,21
2023,1,Riyadh Region,"Repair of computers, personal and household goods",Medium,137,238,107,131,13849,13753,96
2023,1,Qassim Region,"Repair of computers, personal and household goods",Small,160,32,19,13,2431,2422,9
2023,1,Qassim Region,"Repair of computers, personal and household goods",Large,3,0,0,0,2686,2686,0
2023,1,Qassim Region,"Repair of computers, personal and household goods",Micro,659,69,47,22,1506,1504,2
2023,1,Qassim Region,"Repair of computers, personal and household goods",Medium,25,26,26,0,2278,2271,7
2023,1,Medina Region,"Repair of computers, personal and household goods",Small,18,17,7,10,168,165,3
2023,1,Medina Region,"Repair of computers, personal and household goods",Micro,348,56,36,20,732,720,12
2023,1,Tabuk Region,"Repair of computers, personal and household goods",Small,13,21,10,11,102,102,0
2023,1,Tabuk Region,"Repair of computers, personal and household goods",Micro,263,31,24,7,567,564,3
2023,1,Tabuk Region,"Repair of computers, personal and household goods",Medium,2,0,0,0,131,131,0
2023,1,Jazan Region,"Repair of computers, personal and household goods",Small,10,5,5,0,80,80,0
2023,1,Jazan Region,"Repair of computers, personal and household goods",Micro,268,33,18,15,634,632,2
2023,1,Hail Region,"Repair of computers, personal and household goods",Small,18,27,6,21,167,167,0
2023,1,Hail Region,"Repair of computers, personal and household goods",Micro,302,30,21,9,707,704,3
2023,1,Asir Region,"Repair of computers, personal and household goods",Small,30,17,4,13,255,255,0
2023,1,Asir Region,"Repair of computers, personal and household goods",Micro,559,67,40,27,1278,1275,3
2023,1,Makkah Region,"Repair of computers, personal and household goods",Small,101,177,99,78,939,929,10
2023,1,Makkah Region,"Repair of computers, personal and household goods",Micro,1454,239,139,100,3305,3273,32
2023,1,Makkah Region,"Repair of computers, personal and household goods",Medium,6,115,72,43,401,401,0
2023,1,Najran Region,"Repair of computers, personal and household goods",Small,43,9,3,6,612,610,2
2023,1,Najran Region,"Repair of computers, personal and household goods",Micro,213,18,7,11,494,493,1
2023,1,Najran Region,"Repair of computers, personal and household goods",Medium,5,0,0,0,592,592,0
2023,1,Eastern Region,Extraction of crude oil and natural gas,Small,16,121,97,24,221,221,0
2023,1,Eastern Region,Extraction of crude oil and natural gas,Large,6,66311,62386,3925,7500,6872,628
2023,1,Eastern Region,Extraction of crude oil and natural gas,Micro,31,29,17,12,47,46,1
2023,1,Eastern Region,Extraction of crude oil and natural gas,Medium,10,668,615,53,620,615,5
2023,1,Al-Jawf Region,Extraction of crude oil and natural gas,Micro,7,0,0,0,13,13,0
2023,1,Riyadh Region,Extraction of crude oil and natural gas,Small,9,5,4,1,104,104,0
2023,1,Riyadh Region,Extraction of crude oil and natural gas,Micro,18,8,4,4,28,28,0
2023,1,Riyadh Region,Extraction of crude oil and natural gas,Medium,2,54,40,14,119,119,0
2023,1,Qassim Region,Extraction of crude oil and natural gas,Micro,1,0,0,0,4,4,0
2023,1,Medina Region,Extraction of crude oil and natural gas,Medium,1,76,76,0,33,33,0
2023,1,Jazan Region,Extraction of crude oil and natural gas,Micro,1,0,0,0,2,2,0
2023,1,Asir Region,Extraction of crude oil and natural gas,Micro,3,1,0,1,4,4,0
2023,1,Makkah Region,Extraction of crude oil and natural gas,Large,1,336,333,3,25,25,0
2023,1,Makkah Region,Extraction of crude oil and natural gas,Micro,3,0,0,0,12,12,0
2023,1,Najran Region,Extraction of crude oil and natural gas,Small,2,3,3,0,14,14,0
2023,1,Najran Region,Extraction of crude oil and natural gas,Micro,6,2,2,0,10,9,1
2023,1,Eastern Region,Advertisement and market research,Small,214,1006,423,583,1614,1589,25
2023,1,Eastern Region,Advertisement and market research,Large,3,583,524,59,714,711,3
2023,1,Eastern Region,Advertisement and market research,Micro,689,393,140,253,1294,1271,23
2023,1,Eastern Region,Advertisement and market research,Medium,7,392,101,291,324,319,5
2023,1,Al Bahah Region,Advertisement and market research,Small,2,7,5,2,7,7,0
2023,1,Al Bahah Region,Advertisement and market research,Micro,28,14,9,5,58,58,0
2023,1,Al-Jawf Region,Advertisement and market research,Small,5,7,5,2,30,30,0
2023,1,Al-Jawf Region,Advertisement and market research,Micro,72,12,7,5,164,161,3
2023,1,Northern border Region,Advertisement and market research,Small,3,17,7,10,26,26,0
2023,1,Northern border Region,Advertisement and market research,Micro,29,7,1,6,56,56,0
2023,1,Riyadh Region,Advertisement and market research,Small,630,3743,1515,2228,4660,4416,244
2023,1,Riyadh Region,Advertisement and market research,Large,6,7742,6359,1383,1271,1017,254
2023,1,Riyadh Region,Advertisement and market research,Micro,2033,1269,502,767,3416,3263,153
2023,1,Riyadh Region,Advertisement and market research,Medium,38,1663,914,749,1925,1673,252
2023,1,Qassim Region,Advertisement and market research,Small,35,135,56,79,257,254,3
2023,1,Qassim Region,Advertisement and market research,Micro,159,59,39,20,313,311,2
2023,1,Medina Region,Advertisement and market research,Small,30,87,45,42,157,157,0
2023,1,Medina Region,Advertisement and market research,Micro,227,82,33,49,410,398,12
2023,1,Tabuk Region,Advertisement and market research,Small,10,34,15,19,67,65,2
2023,1,Tabuk Region,Advertisement and market research,Micro,86,26,15,11,183,180,3
2023,1,Jazan Region,Advertisement and market research,Small,11,26,12,14,73,68,5
2023,1,Jazan Region,Advertisement and market research,Micro,102,25,12,13,202,200,2
2023,1,Hail Region,Advertisement and market research,Small,4,6,1,5,22,22,0
2023,1,Hail Region,Advertisement and market research,Micro,74,23,7,16,155,155,0
2023,1,Asir Region,Advertisement and market research,Small,27,123,59,64,205,204,1
2023,1,Asir Region,Advertisement and market research,Micro,171,70,35,35,332,331,1
2023,1,Asir Region,Advertisement and market research,Medium,1,82,1,81,2,2,0
2023,1,Makkah Region,Advertisement and market research,Small,359,1840,766,1074,2785,2603,182
2023,1,Makkah Region,Advertisement and market research,Large,1,77,74,3,227,226,1
2023,1,Makkah Region,Advertisement and market research,Micro,1568,770,313,457,2918,2733,185
2023,1,Makkah Region,Advertisement and market research,Medium,19,889,422,467,811,728,83
2023,1,Najran Region,Advertisement and market research,Small,9,30,10,20,85,85,0
2023,1,Najran Region,Advertisement and market research,Micro,45,14,9,5,107,105,2
2023,1,Eastern Region,Not defined,Small,215,452,234,218,1842,1763,79
2023,1,Eastern Region,Not defined,Large,1,0,0,0,308,244,64
2023,1,Eastern Region,Not defined,Micro,6550,1144,587,557,11560,11469,91
2023,1,Eastern Region,Not defined,Medium,2,14,9,5,202,202,0
2023,1,Al Bahah Region,Not defined,Small,13,30,22,8,87,87,0
2023,1,Al Bahah Region,Not defined,Micro,863,119,87,32,1333,1321,12
2023,1,Al-Jawf Region,Not defined,Small,25,47,19,28,172,172,0
2023,1,Al-Jawf Region,Not defined,Micro,1601,117,73,44,2653,2629,24
2023,1,Northern border Region,Not defined,Small,19,38,16,22,123,123,0
2023,1,Northern border Region,Not defined,Micro,662,75,42,33,1148,1142,6
2023,1,Riyadh Region,Not defined,Small,1136,2402,889,1513,9078,8944,134
2023,1,Riyadh Region,Not defined,Large,7,1544,957,587,2273,1917,356
2023,1,Riyadh Region,Not defined,Micro,74623,6181,2899,3282,169000,167454,1546
2023,1,Riyadh Region,Not defined,Medium,27,563,253,310,1932,1872,60
2023,1,Qassim Region,Not defined,Small,70,116,61,55,693,690,3
2023,1,Qassim Region,Not defined,Micro,3155,350,185,165,6186,6136,50
2023,1,Qassim Region,Not defined,Medium,2,63,36,27,99,58,41
2023,1,Medina Region,Not defined,Small,101,198,112,86,799,795,4
2023,1,Medina Region,Not defined,Micro,4784,557,323,234,8000,7847,153
2023,1,Tabuk Region,Not defined,Small,37,59,32,27,318,318,0
2023,1,Tabuk Region,Not defined,Micro,1835,217,122,95,2993,2970,23
2023,1,Tabuk Region,Not defined,Medium,1,2,2,0,82,42,40
2023,1,Jazan Region,Not defined,Small,54,118,45,73,419,414,5
2023,1,Jazan Region,Not defined,Micro,3746,365,204,161,6473,6405,68
2023,1,Jazan Region,Not defined,Medium,1,17,13,4,117,117,0
2023,1,Hail Region,Not defined,Small,34,76,45,31,342,339,3
2023,1,Hail Region,Not defined,Micro,3633,255,125,130,7524,7489,35
2023,1,Hail Region,Not defined,Medium,1,0,0,0,117,61,56
2023,1,Asir Region,Not defined,Small,104,188,131,57,743,738,5
2023,1,Asir Region,Not defined,Micro,5657,647,398,249,8556,8498,58
2023,1,Asir Region,Not defined,Medium,2,6,4,2,187,187,0
2023,1,Makkah Region,Not defined,Small,411,747,382,365,3415,3331,84
2023,1,Makkah Region,Not defined,Micro,15906,2160,1150,1010,26704,25862,842
2023,1,Makkah Region,Not defined,Medium,8,225,129,96,585,582,3
2023,1,Najran Region,Not defined,Small,46,59,23,36,433,432,1
2023,1,Najran Region,Not defined,Micro,3306,239,131,108,6891,6849,42